嗚呼	ああ	aa	Ah!; Oh!; Alas!
相	あい	ai	together; mutually; fellow
相変わらず	あいかわらず	aikawarazu	as ever; as usual; the same
愛想	あいそ	aiso	civility; courtesy; compliments; sociability; graces
相対	あいたい	aitai	confrontation; facing; between ourselves; no third party; tete-a-tete
間柄	あいだがら	aidagara	relation(ship)
愛憎	あいぞう	aizou	likes and dislikes
合間	あいま	aima	interval
曖昧	あいまい	aimai	vague; ambiguous
敢えて	あえて	aete	dare (to do); challenge (to do)
仰ぐ	あおぐ	aogu	to look up (to); to respect; to depend on; to ask for; to seek; to revere; to drink; to take
垢	あか	aka	dirt; filth
亜科	あか	aka	suborder; subfamily
銅	あかがね	akagane	copper
証	あかし	akashi	proof; evidence
赤字	あかじ	akaji	deficit; go in the red
明かす	あかす	akasu	to pass; spend; to reveal; to divulge
赤ちゃん	あかちゃん	akachan	baby; infant
明白	あからさま	akarasama	obvious; overt; plainly; frankly
赤らむ	あからむ	akaramu	to become red; to redden; to blush
明るい	あかるい	akarui	bright; cheerful
上がり	あがり	agari	1. slope; advance income; crop yield; ascent; rise; advance; death; spinning; completion; stop; finish; after
上がる	あがる	agaru	to enter; to go up; to rise; to climb up; to advance; to appreciate; to be promoted; to improve; to call on;
商人	あきうど	akiudo	trader; shopkeeper; merchant
空間	あきま	akima	vacancy; room for rent or lease
諦め	あきらめ	akirame	resignation; acceptance; consolation
呆れる	あきれる	akireru	to be amazed; to be shocked
悪	あく	aku	evil; wickedness
灰	あく	aku	ash
	あくどい	akudoi	1. gaudy; showy; excessive; 2. vicious
悪日	あくび	akubi	unlucky day
明くる	あくる	akuru	next; following
憧れ	あこがれ	akogare	yearning; longing; aspiration
顎	あご	ago	chin
麻	あさ	asa	flax; linen; hemp
明後日	あさって	asatte	day after tomorrow
朝寝坊	あさねぼう	asanebou	oversleeping; late riser
浅ましい	あさましい	asamashii	wretched; miserable; shameful; mean; despicable; abject
字	あざ	aza	section of village
欺く	あざむく	azamuku	to deceive
鮮やか	あざやか	azayaka	vivid; clear; brilliant
あざ笑う	あざわらう	azawarau	to sneer at; to ridicule
味わい	あじわい	ajiwai	flavour; meaning; significance
東	あずま	azuma	east; Eastern Japan
焦る	あせる	aseru	to be in a hurry; to be impatient
彼処	あそこ	asoko	1. (uk) there; over there; that place; 2. (X) (col) genitals
値	あたい	atai	value; price; cost; worth; merit
値する	あたいする	ataisuru	to be worth; to deserve; to merit
私	あたし	atashi	I (fem)
当たり	あたり	atari	hit; success; reaching the mark; per ...; vicinity; neighborhood
当たり前	あたりまえ	atarimae	usual; common; ordinary; natural; reasonable; obvious
他人	あだびと	adabito	another person; unrelated person; outsider; stranger
彼方此方	あちこち	achikochi	here and there
彼方	あちら	achira	1. there; yonder; that
彼方此方	あちらこちら	achirakochira	here and there
悪化	あっか	akka	deterioration; growing worse; aggravation; degeneration; corruption
呆気ない	あっけない	akkenai	not enough; too quick (short long etc.)
悪口	あっこう	akkou	abuse; insult; slander; evil speaking
	あっさり	assari	easily; readily; quickly
圧迫	あっぱく	appaku	pressure; coercion; oppression
扱い	あつかい	atsukai	treatment; service
集まる	あつまる	atsumaru	to gather; to collect; to assemble
誂える	あつらえる	atsuraeru	to give an order; to place an order
圧力	あつりょく	atsuryoku	stress; pressure
当て	あて	ate	object; aim; end; hopes; expectations
宛	あて	ate	addressed to
当て字	あてじ	ateji	phonetic-equivalent character; substitute character
当てはまる	あてはまる	atehamaru	to apply (a rule)
当てはめる	あてはめる	atehameru	to apply; to adapt
宛てる	あてる	ateru	to address
跡継ぎ	あとつぎ	atotsugi	heir; successor
後回し	あとまわし	atomawashi	putting off; postponing
貴女	あなた	anata	you; lady
彼の	あの	ano	that over there
溢れる	あふれる	afureru	to flood; to overflow; to brim over
油絵	あぶらえ	aburae	oil painting
炙る	あぶる	aburu	to scorch
	あべこべ	abekobe	contrary; opposite; inverse
甘える	あまえる	amaeru	to behave like a spoiled child; to fawn on
甘口	あまくち	amakuchi	sweet flavour; mildness; flattery; stupidity
雨具	あまぐ	amagu	rain gear
天	あまつ	amatsu	heavenly; imperial
網	あみ	ami	net; network
天地	あめつち	ametsuchi	heaven and earth; the universe; nature; top and bottom; realm; sphere; world
操る	あやつる	ayatsuru	to manipulate; to operate; to pull strings
	あやふや	ayafuya	uncertain; vague; ambiguous
危ぶむ	あやぶむ	ayabumu	to fear; to have misgivings; to be doubtful; to mistrust
過ち	あやまち	ayamachi	fault; error; indiscretion
誤る	あやまる	ayamaru	to make a mistake
歩み	あゆみ	ayumi	walking
歩む	あゆむ	ayumu	to walk; to go on foot
	あら	ara	oh; ah; saw-edged perch (Niphon spinosus)
予め	あらかじめ	arakajime	beforehand; in advance; previously
荒らす	あらす	arasu	to lay waste; to devastate; to damage; to invade; to break into
粗筋	あらすじ	arasuji	outline; summary
争い	あらそい	arasoi	dispute; strife; quarrel; dissension; conflict; rivalry; contest
改まる	あらたまる	aratamaru	to be renewed
荒っぽい	あらっぽい	arappoi	rough; rude
凡ゆる	あらゆる	arayuru	all; every
	あられ	arare	kind of cookie; cartoon character
現われ	あらわれ	araware	embodiment; materialization
現われる	あらわれる	arawareru	to appear; to come in sight; to become visible; to come out; to embody; to materialize; to express oneself
有難う	ありがとう	arigatou	Thank you
有様	ありさま	arisama	state; condition; circumstances; the way things are or should be; truth
有りのまま	ありのまま	arinomama	the truth; fact; as it is; frankly
或る	ある	aru	a certain...; some...
或いは	あるいは	aruiwa	or; possibly
彼此	あれこれ	arekore	one thing or another; this and that; this or that
合わす	あわす	awasu	to join together; to face; to unite; to be opposite; to combine; to connect; to add up; to mix; to match; to
合わせ	あわせ	awase	joint together; opposite; facing
慌ただしい	あわただしい	awatadashii	busy; hurried; confused; flurried
慌てる	あわてる	awateru	to become confused (disconcerted disorganized)
暗殺	あんさつ	ansatsu	assassination
暗算	あんざん	anzan	mental arithmetic
暗示	あんじ	anji	hint; suggestion
案じる	あんじる	anjiru	to be anxious; to ponder
安静	あんせい	ansei	rest
案の定	あんのじょう	annojou	sure enough; as usual
余り	あんまり	anmari	not very (this form only used as adverb); not much; remainder; rest; remnant; surplus; balance; excess; rema
依	い	i	depending on
良い	いい	ii	good
否	いいえ	iie	no; nay; yes; well
いい加減	いいかげん	iikagen	moderate; right; random; not thorough; vague; irresponsible; halfhearted
言い訳	いいわけ	iiwake	excuse; explanation
家出	いえで	iede	running away from home; leaving home
家主	いえぬし	ienushi	landlord
如何	いかが	ikaga	how; in what way
生かす	いかす	ikasu	to revive; to resuscitate; to make use of
雷	いかずち	ikazuchi	thunder
如何に	いかに	ikani	how?; in what way?; how much?; however; whatever
如何にも	いかにも	ikanimo	indeed; really; phrase meaning agreement
怒り	いかり	ikari	anger; hatred
怒る	いかる	ikaru	to get angry; to be angry
歪む	いがむ	igamu	to warp; to swerve; to deflect; to be crooked; to be distorted; to be bent; to incline; to slant; to be perv
粋	いき	iki	chic; style; purity; essence
域外	いきがい	ikigai	outside the area
意気込む	いきごむ	ikigomu	to be enthusiastic about
経緯	いきさつ	ikisatsu	1. details; whole story; sequence of events; particulars; how it started; how things got this way; 2. c
行き違い	いきちがい	ikichigai	misunderstanding; estrangement; disagreement; crossing without meeting; going astray
行き成り	いきなり	ikinari	suddenly
異議	いぎ	igi	objection; dissent; protest
	いく	iku	to come; to orgasm
軍/戦	いくさ	ikusa	war; battle; campaign; fight
育成	いくせい	ikusei	rearing; training; nurture; cultivation; promotion
幾多	いくた	ikuta	many; numerous
活ける	いける	ikeru	to arrange (flowers)
異見	いけん	iken	different opinion; objection
意向	いこう	ikou	intention; idea; inclination
移行	いこう	ikou	switching over to
	いざ	iza	now; come (now); well; crucial moment
碑	いしぶみ	ishibumi	stone monument bearing an inscription
衣装	いしょう	ishou	clothing; costume; outfit; garment; dress
意地	いじ	iji	disposition; spirit; willpower; obstinacy; backbone; appetite
苛める	いじめる	ijimeru	to tease; to torment; to persecute; to chastise
移住	いじゅう	ijuu	migration; immigration
弄る	いじる	ijiru	to touch; to tamper with
何れ	いずれ	izure	where; which; who; anyway; anyhow; at any rate
異性	いせい	isei	the opposite sex
遺跡	いせき	iseki	historic ruins (remains relics)
依然	いぜん	izen	still; as yet
依存	いそん	ison	dependence; dependent; reliance
委託	いたく	itaku	consign (goods (for sale) to a firm); entrust (person with something); commit
悪戯	いたずら	itazura	tease; prank; trick; practical joke; mischief
頂	いただき	itadaki	(top of) head; summit; spire
戴きます	いただきます	itadakimasu	expression of gratitude before meals
至って	いたって	itatte	very much; exceedingly; extremely
痛む	いたむ	itamu	to hurt; to feel a pain; to be injured
痛める	いためる	itameru	to hurt; to injure; to cause pain; to worry; to bother; to afflict; to be grieved over
炒める	いためる	itameru	to stir-fry
労る	いたわる	itawaru	to pity; to sympathize with; to console; to care for; to be kind to
市	いち	ichi	market; fair
位地	いち	ichi	place; situation; position; location
一々	いちいち	ichiichi	one by one; separately
一概に	いちがいに	ichigaini	unconditionally; as a rule
一見	いちげん	ichigen	unfamiliar; never before met
一言	いちげん	ichigen	single word
一日	いちじつ	ichijitsu	1. one day; 2. first of month
一定	いちじょう	ichijou	fixed; settled; definite; uniform; regularized; defined; standardized; certain; prescribed
著しい	いちじるしい	ichijirushii	remarkable; considerable
一同	いちどう	ichidou	all present; all concerned; all of us
一人	いちにん	ichinin	one person
一部	いちぶ	ichibu	1. one copy e.g. of a document; 2. a part; partly; some
一部分	いちぶぶん	ichibubun	a part
一別	いちべつ	ichibetsu	parting
一面	いちめん	ichimen	one side; one phase; front page; the other hand; the whole surface
一目	いちもく	ichimoku	a glance; a look; a glimpse
一様	いちよう	ichiyou	uniformity; evenness; similarity; equality; impartiality
一律	いちりつ	ichiritsu	evenness; uniformity; monotony; equality
一連	いちれん	ichiren	a series; a chain; a ream (of paper)
一括	いっかつ	ikkatsu	all together; batch; one lump; one bundle; summing up
一気	いっき	ikki	drink!(said repeatedly as a party cheer)
一挙に	いっきょに	ikkyoni	at a stroke; with a single swoop
一切	いっさい	issai	all; everything; without exception; the whole; entirely; absolutely
一心	いっしん	isshin	one mind; wholeheartedness; the whole heart
	いっそ	isso	rather; sooner; might as well
一帯	いったい	ittai	a region; a zone; the whole place
一敗	いっぱい	ippai	one defeat
一変	いっぺん	ippen	complete change; about-face
何時	いつ	itsu	when; how soon
何時か	いつか	itsuka	sometime; someday; one day; some time or other; the other day; in due course; in time
何時でも	いつでも	itsudemo	(at) any time; always; at all times; never (neg); whenever
何時の間にか	いつのまにか	itsunomanika	before one knows; unnoticed; unawares
何時までも	いつまでも	itsumademo	forever; for good; eternally; as long as one likes; indefinitely
何時も	いつも	itsumo	always; usually; every time; never (with neg. verb)
意図	いと	ito	intention; aim; design
営む	いとなむ	itonamu	to carry on (e.g. in ceremony); to run a business
暇	いとま	itoma	free time; leisure; leave; spare time; farewell
異動	いどう	idou	a change
挑む	いどむ	idomu	to challenge; to contend for; to make love to
稲光	いなびかり	inabikari	(flash of) lightning
古	いにしえ	inishie	antiquity; ancient times
祈り	いのり	inori	prayer; supplication
鼾	いびき	ibiki	snoring
今更	いまさら	imasara	now; at this late hour
未だ	いまだ	imada	as yet; hitherto; not yet (neg)
移民	いみん	imin	emigration; immigration; emigrant; immigrant
厭々	いやいや	iyaiya	unwillingly; grudgingly; shaking head in refusal (to children)
卑しい	いやしい	iyashii	greedy; vulgar; shabby; humble; base; mean; vile
	いやに	iyani	awfully; terribly
厭やらしい	いやらしい	iyarashii	detestable; disagreeable
愈々	いよいよ	iyoiyo	more and more; all the more; increasingly; at last; beyond doubt
意欲	いよく	iyoku	will; desire; ambition
苛々	いらいら	iraira	getting nervous; irritation
入口	いりくち	irikuchi	entrance; gate; approach; mouth
衣料	いりょう	iryou	clothing
威力	いりょく	iryoku	power; might; authority; influence
入る	いる	iru	to get in; to go in; to come in; to flow into; to set; to set in
衣類	いるい	irui	clothes; clothing; garments
色々	いろいろ	iroiro	various
異論	いろん	iron	different opinion; objection
所謂	いわゆる	iwayuru	the so-called; so to speak
印	いん	in	seal; stamp; mark; print
員	いん	in	member
印鑑	いんかん	inkan	stamp; seal
陰気	いんき	inki	gloom; melancholy
隠居	いんきょ	inkyo	retirement; retired person
上下	うえした	ueshita	high and low; up and down; unloading and loading; praising and blaming
浮かぶ	うかぶ	ukabu	to float; to rise to surface; to come to mind
受かる	うかる	ukaru	to pass (examination)
含嗽	うがい	ugai	gargle; rinse mouth
受け入れ	うけいれ	ukeire	receiving; acceptance
受け入れる	うけいれる	ukeireru	to accept; to receive
受け継ぐ	うけつぐ	uketsugu	to inherit; to succeed; to take over
受け付ける	うけつける	uketsukeru	to be accepted; to receive (an application)
受け止める	うけとめる	uketomeru	to catch; to stop the blow; to react to; to take
受け取り	うけとり	uketori	receipt
受身	うけみ	ukemi	passive; passive voice
動き	うごき	ugoki	movement; activity; trend; development; change
潮	うしお	ushio	tide
氏	うじ	uji	family name
渦	うず	uzu	swirl
埋まる	うずまる	uzumaru	to be buried; to be surrounded; to overflow; to be filled
嘘つき	うそつき	usotsuki	liar (sometimes said with not much seriousness); fibber
打ち合わせ	うちあわせ	uchiawase	business meeting; previous arrangement; appointment
打ち合わせる	うちあわせる	uchiawaseru	to knock together; to arrange
打ち切る	うちきる	uchikiru	to stop; to abort; to discontinue; to close
打ち消し	うちけし	uchikeshi	negation; denial; negative
打ち込む	うちこむ	uchikomu	to drive in (e.g. nail stake); to devote oneself to; to shoot into; to smash; to throw into; to cast int
団扇	うちわ	uchiwa	fan
内訳	うちわけ	uchiwake	the items; breakdown; classification
訴え	うったえ	uttae	lawsuit; complaint
鬱陶しい	うっとうしい	uttoushii	gloomy; depressing
写し	うつし	utsushi	copy; duplicate; facsimile; transcript
空ろ	うつろ	utsuro	blank; cavity; hollow; empty (space)
器	うつわ	utsuwa	bowl; vessel; container
雨天	うてん	uten	rainy weather
腕前	うでまえ	udemae	ability; skill; facility
饂飩	うどん	udon	noodles (Japanese)
促す	うながす	unagasu	to urge; to press; to suggest; to demand; to stimulate; to quicken; to incite; to invite (attention to)
唸る	うなる	unaru	to groan; to moan; to roar; to howl; to growl; to hum; to buzz; to sough
自惚れ	うぬぼれ	unubore	pretension; conceit; hubris
甘い	うまい	umai	delicious
生まれつき	うまれつき	umaretsuki	by nature; by birth; native
海路	うみじ	umiji	sea route
産む	うむ	umu	to give birth; to deliver; to produce
埋め込む	うめこむ	umekomu	to bury
梅干	うめぼし	umeboshi	dried plum
末	うら	ura	top end; tip
裏返し	うらがえし	uragaeshi	inside out; upside down
売り出し	うりだし	uridashi	(bargain) sale
売り出す	うりだす	uridasu	to put on sale; to market; to become popular
潤う	うるおう	uruou	to be moist; to be damp; to get wet; to profit by; to be watered; to receive benefits; to favor; to charm; t
五月蝿い	うるさい	urusai	noisy; loud; fussy
売れ行き	うれゆき	ureyuki	sales
浮気	うわき	uwaki	flighty; fickle; wanton; unfaithful
上手	うわて	uwate	1. upper part; upper stream; left side (of a stage); 2. skillful (only in comparisons); dexterity (on
上回る	うわまわる	uwamawaru	to exceed
植わる	うわる	uwaru	to be planted
運営	うんえい	unei	management; administration; operation
	うんざり	unzari	tedious; boring; being fed up with
運送	うんそう	unsou	shipping; marine transportation
運賃	うんちん	unchin	freight rates; shipping expenses; fare
云々	うんぬん	unnun	and so on; and so forth; comment
運搬	うんぱん	unpan	transport; carriage
運命	うんめい	unmei	fate
運輸	うんゆ	unyu	transportation
運用	うんよう	unyou	making use of; application; investment; practical use
会	え	e	understanding
重	え	e	-fold; -ply
	えい	ei	ray (fish)
映写	えいしゃ	eisha	projection
英字	えいじ	eiji	English letter (character)
衛生	えいせい	eisei	health; hygiene; sanitation; medical
映像	えいぞう	eizou	reflection; image
英雄	えいゆう	eiyuu	hero; great man
液	えき	eki	liquid; fluid
役	えき	eki	war; campaign; battle
閲覧	えつらん	etsuran	inspection; reading
獲物	えもの	emono	game; spoils; trophy
襟	えり	eri	neck; collar; lapel; neckband
縁	えん	en	chance; fate; destiny; relation; bonds; connection; karma
塩	えん	en	salt
艶	えん	en	charming; fascinating; voluptuous
園	えん	en	garden (esp. man-made)
円滑	えんかつ	enkatsu	harmony; smoothness
縁側	えんがわ	engawa	veranda; porch; balcony; open corridor
沿岸	えんがん	engan	coast; shore
婉曲	えんきょく	enkyoku	euphemistic; circumlocution; roundabout; indirect; insinuating
演習	えんしゅう	enshuu	practice; exercises; manoeuvers
演出	えんしゅつ	enshutsu	production (e.g. play); direction
演じる/演ずる	えんじる/えんずる	enjiru/ enzuru	to perform; to play
沿線	えんせん	ensen	along railway line
縁談	えんだん	endan	marriage proposal; engagement
遠方	えんぽう	enpou	long way; distant place
円満	えんまん	enman	perfection; harmony; peace; smoothness; completeness; satisfaction; integrity
尾	お	o	tail; ridge
於て	おいて	oite	at; in; on
甥	おい	oi	nephew
追い込む	おいこむ	oikomu	to herd; to corner; to drive
美味しい	おいしい	oishii	delicious; tasty
追い出す	おいだす	oidasu	to expel; to drive out
於いて	おいて	oite	at; in; on
お出でになる	おいでになる	oideninaru	to be
老いる	おいる	oiru	to age; to grow old
負う	おう	ou	to bear; to owe
応急	おうきゅう	oukyuu	emergency
黄金	おうごん	ougon	gold
黄色	おうしょく	oushoku	yellow
応募	おうぼ	oubo	subscription; application
	おおい	ooi	hey!
大方	おおかた	ookata	perhaps; almost all; majority
大柄	おおがら	oogara	large build; large pattern
大げさ	おおげさ	oogesa	grandiose; exaggerated
大事	おおごと	oogoto	important; valuable; serious matter
大ざっぱ	おおざっぱ	oozappa	rough (as in not precise); broad; sketchy
大筋	おおすじ	oosuji	outline; summary
大空	おおぞら	oozora	heaven; firmament; the sky
大幅	おおはば	oohaba	full width; large scale; drastic
大水	おおみず	oomizu	flood
公	おおやけ	ooyake	official; public; formal; open; governmental
お蔭	おかげ	okage	(your) backing; assistance
お蔭様で	おかげさまで	okagesamade	Thanks to god; thanks to you
可笑しい	おかしい	okashii	strange; funny; amusing; ridiculous
犯す	おかす	okasu	to commit; to perpetrate; to violate; to rape
侵す	おかす	okasu	to invade; to raid; to trespass; to violate; to intrude on
お菜	おかず	okazu	side dish; accompaniment for rice dishes
臆病	おくびょう	okubyou	cowardice; timidity
遅らす	おくらす	okurasu	to retard; to delay
遅れ	おくれ	okure	delay; lag
起こす	おこす	okosu	to raise; to cause; to wake someone
行い	おこない	okonai	deed; conduct; behavior; action; asceticism
厳か	おごそか	ogosoka	austere; majestic; dignified; stately; awful; impressive
傲る	おごる	ogoru	to be proud
長	おさ	osa	chief; head
押さえる	おさえる	osaeru	to stop; to restrain; to seize; to repress; to suppress; to press down
お先に	おさきに	osakini	before; ahead; previously
収まる	おさまる	osamaru	to be obtained; to end; to settle into; to fit into; to be settled; to be paid; to be delivered
収まる/納まる	おさまる	osamaru	to be obtained; to end; to settle into; to fit into; to be settled; to be paid; to be delivered
お産	おさん	osan	(giving) birth
教え	おしえ	oshie	teachings; precept; lesson; doctrine
押し込む	おしこむ	oshikomu	to push into; to crowd into
惜しむ	おしむ	oshimu	to be frugal; to value; to regret
お喋り	おしゃべり	oshaberi	chattering; talk; idle talk; chat; chitchat; gossip; chatty; talkative; chatterbox; blabbermouth
お洒落	おしゃれ	oshare	smartly dressed; someone smartly dressed; fashion-conscious
押し寄せる	おしよせる	oshiyoseru	to push aside; to advance on
お祖父さん	おじいさん	ojiisan	grandfather; male senior-citizen
お邪魔します	おじゃまします	ojamashimasu	Excuse me for disturbing (interrupting) you
雄	おす	osu	male (animal)
お世辞	おせじ	oseji	flattery; compliment
襲う	おそう	osou	to attack
遅くとも	おそくとも	osokutomo	at the latest
恐らく	おそらく	osoraku	perhaps
恐れ	おそれ	osore	fear; horror
恐れ入る	おそれいる	osoreiru	to be filled with awe; to feel small; to be amazed; to be surprised; to be disconcerted; to be sorry; to b
お大事に	おだいじに	odaijini	Take care of yourself
煽てる	おだてる	odateru	to stir up; to instigate; to flatter
落ち込む	おちこむ	ochikomu	to fall into; to feel down (sad)
落ち着き	おちつき	ochitsuki	calm; composure
落ち葉	おちば	ochiba	fallen leaves; leaf litter; defoliation; shedding leaves
落ちる	おちる	ochiru	to fail (e.g. exam); to fall down; to drop
	おっかない	okkanai	frightening; huge
仰っしゃる	おっしゃる	ossharu	to say; to speak; to tell; to talk
乙	おつ	otsu	1. strange; quaint; stylish; chic; spicy; queer; witty; tasty; romantic; 2. 2nd in rank; second sign of the
お使い	おつかい	otsukai	errand
お手上げ	おてあげ	oteage	all over; given in; given up hope; bring to knees
御手洗い	おてあらい	otearai	toilet; restroom; lavatory; bathroom (US)
弟	おと	oto	younger brother
落とす	おとす	otosu	to drop; to lose; to let fall
訪れる	おとずれる	otozureru	to visit
大人しい	おとなしい	otonashii	obedient; docile; quiet
少女	おとめ	otome	daughter; young lady; virgin; maiden; little girl
お供	おとも	otomo	attendant; companion
衰える	おとろえる	otoroeru	to become weak; to decline; to wear; to abate; to decay; to wither; to waste away
	おどおど	odoodo	coweringly; hesitantly
脅かす/脅す	おどかす/おどす	odokasu/ odosu	to threaten; to menace
驚き	おどろき	odoroki	surprise; astonishment; wonder
同い年	おないどし	onaidoshi	of the same age
女子	おなご	onago	woman; girl
お願いします	おねがいします	onegaishimasu	please
各	おのおの	onoono	each; every; either; respectively; severally
自ずから	おのずから	onozukara	naturally; as a matter of course
お早う	おはよう	ohayou	Good morning
お祖母さん	おばあさん	obaasan	grandmother; female senior-citizen
怯える	おびえる	obieru	to become frightened; to have a nightmare
夥しい	おびただしい	obitadashii	abundantly; innumerably
帯びる	おびる	obiru	to wear; to carry; to be entrusted; to have; to take on; to have a trace of; to be tinged with
覚え	おぼえ	oboe	memory; sense; experience
御負け	おまけ	omake	1. a discount; a prize; 2. something additional; bonus; an extra; 3. an exaggeration
お宮	おみや	omiya	Shinto shrine
お襁褓	おむつ	omutsu	diaper; nappy
お目出度う	おめでとう	omedetou	(ateji) (int) (uk) Congratulations!; an auspicious occasion!
面	おも	omo	face
思い付き	おもいつき	omoitsuki	plan; idea; suggestion
面白い	おもしろい	omoshiroi	interesting; amusing
玩具	おもちゃ	omocha	toy
重なる	おもなる	omonaru	main; principal; important
趣	おもむき	omomuki	meaning; tenor; gist; effect; appearance; taste; grace; charm; refinement
赴く	おもむく	omomuku	to go; to proceed; to repair to; to become
重役	おもやく	omoyaku	heavy responsibilities; director
重んずる/重んずる	おもんずる/重んじる	omonzuru/ omonjiru	to respect; to honor; to esteem; to prize
お休み	おやすみ	oyasumi	holiday; absence; rest; Good night
お八	おやつ	oyatsu	1. (uk) between meal snack; afternoon refreshment; afternoon tea; 2. mid-day snack
凡そ	およそ	oyoso	about; roughly; as a rule; approximately
及び	および	oyobi	and; as well as
及ぶ	およぶ	oyobu	to reach; to come up to; to amount to; to befall; to happen to; to extend; to match; to equal
織	おり	ori	weave; weaving; woven item
檻	おり	ori	cage; pen; jail cell
折り返す	おりかえす	orikaesu	to turn up; to fold back
織物	おりもの	orimono	textile; fabric
織る	おる	oru	to weave
俺	おれ	ore	I (ego) (boastful first-person pronoun)
愚か	おろか	oroka	foolish; stupid
疎か	おろそか	orosoka	neglect; negligence; carelessness
終わる	おわる	owaru	to finish; to close
音色	おんいろ	oniro	tone color; tone quality; timbre; synthesizer patch
温和	おんわ	onwa	gentle; mild; moderate
仮	か	ka	tentative; provisional
科	か	ka	department; section
個	か	ka	article counter
下位	かい	kai	low rank; subordinate; lower order (e.g. byte)
階	かい	kai	-floor (counter); stories
改悪	かいあく	kaiaku	deterioration; changing for the worse
海運	かいうん	kaiun	maritime; marine transportation
改革	かいかく	kaikaku	reform; reformation; innovation
貝殻	かいがら	kaigara	shell
階級	かいきゅう	kaikyuu	class; rank; grade
海峡	かいきょう	kaikyou	channel
会見	かいけん	kaiken	interview; audience
介護	かいご	kaigo	nursing
開催	かいさい	kaisai	holding a meeting; open an exhibition
回収	かいしゅう	kaishuu	collection; recovery
改修	かいしゅう	kaishuu	repair; improvement
怪獣	かいじゅう	kaijuu	monster
解除	かいじょ	kaijo	cancellation; rescinding; release; calling off
回送	かいそう	kaisou	forwarding
階層	かいそう	kaisou	class; level; stratum; hierarchy
開拓	かいたく	kaitaku	reclamation (of wasteland); cultivation; pioneer
会談	かいだん	kaidan	conversation; conference; discussion; interview
改定	かいてい	kaitei	reform
改訂	かいてい	kaitei	revision
街道	かいどう	kaidou	highway
介入	かいにゅう	kainyuu	intervention
開発	かいはつ	kaihatsu	development; exploitation
海抜	かいばつ	kaibatsu	height above sea level
介抱	かいほう	kaihou	nursing; looking after
解剖	かいぼう	kaibou	dissection; autopsy
回覧	かいらん	kairan	circulation
海流	かいりゅう	kairyuu	ocean current
改良	かいりょう	kairyou	improvement; reform
回路	かいろ	kairo	circuit (electric)
顧みる/省みる	かえりみる	kaerimiru	to look back; to turn around; to review
返る	かえる	kaeru	to return; to come back; to go back
顔付き	かおつき	kaotsuki	(outward) looks; features; face; countenance; expression
掲げる	かかげる	kakageru	to publish; to print; to carry (an article); to put up; to hang out; to hoist; to fly (a sail); to float (a
踵	かかと	kakato	(shoe) heel
係り	かかり	kakari	official; duty; person in charge
課外	かがい	kagai	extracurricular
書き取り	かきとり	kakitori	dictation
書き取る	かきとる	kakitoru	to write down; to take dictation; to take notes
掻き回す	かきまわす	kakimawasu	to stir up; to churn; to ransack; to disturb
欠く	かく	kaku	to lack; to break; to crack; to chip
角	かく	kaku	1. angle; 2. bishop (shogi)
核	かく	kaku	nucleus; kernel
格	かく	kaku	status; character; case
佳句	かく	kaku	beautiful passage of literature
画	かく	kaku	stroke
格差	かくさ	kakusa	qualitative difference; disparity
拡散	かくさん	kakusan	scattering; diffusion
各種	かくしゅ	kakushu	every kind; all sorts
隔週	かくしゅう	kakushuu	every other week
確信	かくしん	kakushin	conviction; confidence
革新	かくしん	kakushin	reform; innovation
確定	かくてい	kakutei	definition (math); decision; settlement
獲得	かくとく	kakutoku	acquisition; possession
確保	かくほ	kakuho	guarantee; ensure; maintain; insure; secure
革命	かくめい	kakumei	revolution
確立	かくりつ	kakuritsu	establishment
賭け	かけ	kake	betting; gambling; a gamble
掛け	かけ	kake	credit
駆け足	かけあし	kakeashi	running fast; double time
家計	かけい	kakei	household economy; family finances
駆けっこ	かけっこ	kakekko	(foot) race
駆ける	かける	kakeru	to run (race esp. horse); to gallop; to canter
賭ける	かける	kakeru	to wager; to bet; to risk; to stake; to gamble
ヶ月	かげつ	kagetsu	(number of) months
加工	かこう	kakou	manufacturing; processing; treatment
化合	かごう	kagou	chemical combination
嵩張る	かさばる	kasabaru	to be bulky; to be unwieldy; to grow voluminous
嵩む	かさむ	kasamu	to pile up; to increase
風車	かざぐるま	kazaguruma	1. windmill; 2. pinwheel
畏まりました	かしこまりました	kashikomarimashita	certainly!
華奢	かしゃ	kasha	luxury; pomp; delicate; slender; gorgeous
箇所	かしょ	kasho	passage; place; point; part
火傷	かしょう	kashou	burn; scald
箇条書き	かじょうがき	kajougaki	itemized form; itemization
噛る	かじる	kajiru	to chew; to bite (at); to gnaw; to nibble; to munch; to crunch; to have a smattering of
微か	かすか	kasuka	faint; dim; weak; indistinct; hazy; poor; wretched
霞む	かすむ	kasumu	to grow hazy; to be misty
化する	かする	kasuru	to change into; to convert into; to transform; to be reduced; to influence; to improve (someone)
擦る	かする	kasuru	to touch lightly; to take a percentage (from)
火星	かせい	kasei	Mars (planet)
化石	かせき	kaseki	fossil; petrifaction; fossilization
河川	かせん	kasen	rivers
化繊	かせん	kasen	synthetic fibres
過疎	かそ	kaso	depopulation
過多	かた	kata	excess; superabundance
難い	かたい	katai	difficult; hard
片思い	かたおもい	kataomoi	unrequited love
敵	かたき	kataki	enemy; rival
気質	かたぎ	katagi	spirit; character; trait; temperament; disposition
片言	かたこと	katakoto	a smattering; talk like a baby; speak haltingly
片付け	かたづけ	katazuke	tidying up; finishing
傾く	かたぶく	katabuku	to incline toward; to slant; to lurch; to heel over; to be disposed to; to trend toward; to be prone to; to
傾ける	かたむける	katamukeru	to incline; to list; to bend; to lean; to tip; to tilt; to slant; to concentrate on; to ruin (a country); to
固める	かためる	katameru	to harden; to freeze; to fortify
偏る	かたよる	katayoru	to be one-sided; to incline; to be partial; to be prejudiced; to lean; to be biased
傍ら	かたわら	katawara	beside(s); while; nearby
課題	かだい	kadai	subject; theme; task
花壇	かだん	kadan	flower bed
家畜	かちく	kachiku	domestic animals; livestock; cattle
画期	かっき	kakki	epoch-making
活発	かっぱつ	kappatsu	vigor; active
且つ	かつ	katsu	yet; and
割	かつ	katsu	divide; cut; halve; separate; split; rip; break; crack; smash; dilute
嘗て	かつて	katsute	once; ever
日付	かづけ	kazuke	date; dating
門	かど	kado	gate
叶う	かなう	kanau	to come true (wish)
叶える	かなえる	kanaeru	to grant (request wish)
金槌	かなづち	kanazuchi	1. (iron) hammer; 2. punishment
鉄棒	かなぼう	kanabou	iron rod; crowbar; horizontal bar (gymnastics)
可成	かなり	kanari	considerably; fairly; quite
加入	かにゅう	kanyuu	becoming a member; joining; entry; admission; subscription; affiliation; adherence; signing
金庫	かねぐら	kanegura	safe; vault; treasury; provider of funds
予言	かねごと	kanegoto	prediction; promise; prognostication
兼ねて	かねて	kanete	simultaneously
下番	かばん	kaban	going off duty
下品	かひん	kahin	inferior article
華美	かび	kabi	pomp; splendor; gaudiness
花粉	かふん	kafun	pollen
株式	かぶしき	kabushiki	stock (company)
気触れる	かぶれる	kabureru	to react to; to be influenced by; to go overboard for
貨幣	かへい	kahei	money; currency; coinage
構え	かまえ	kamae	posture; pose; style
構える	かまえる	kamaeru	to set up
加味	かみ	kami	seasoning; flavoring
噛み切る	かみきる	kamikiru	to bite off; to gnaw through
過密	かみつ	kamitsu	crowded
瓶	かめ	kame	earthenware pot
かも知れない	かもしれない	kamoshirenai	may; might; perhaps; may be; possibly
粥	かゆ	kayu	(rice) gruel
痒い	かゆい	kayui	itchy; itching
揶揄う	からかう	karakau	to ridicule; to tease; to banter with; to make fun of
身体	からだ	karada	the body
体付き	からだつき	karadatsuki	body build; figure
絡む	からむ	karamu	to entangle; to entwine
借り	かり	kari	borrowing; debt; loan
下吏	かり	kari	lower official
加留多	かるた	karuta	(pt:) (n) playing cards (pt: carta)
涸れる	かれる	kareru	to dry up; to run out
過労	かろう	karou	overwork; strain
辛うじて	かろうじて	karoujite	barely; narrowly; just manage to do st
側	かわ	kawa	side; row; surroundings; part; (watch) case
可愛い	かわいい	kawaii	pretty; cute; lovely; charming; dear; darling; pet
可愛がる	かわいがる	kawaigaru	to love; to be affectionate
可哀想	かわいそう	kawaisou	poor; pitiable; pathetic
可愛らしい	かわいらしい	kawairashii	lovely; sweet
交わす	かわす	kawasu	to exchange (messages); to dodge; to parry; to avoid; to turn aside
代わる	かわる	kawaru	to take the place of; to relieve; to be substituted for; to be exchanged; to change places with; to take
代わる代わる	かわるがわる	kawarugawaru	alternately
乾	かん	kan	heaven; emperor
管	かん	kan	pipe; tube
幹	かん	kan	(tree) trunk
冠	かん	kan	crown; diadem; first; best; peerless; cap; naming; designating; initiating on coming of age; top character ra
観	かん	kan	look; appearance; spectacle
館	かん	kan	house; hall; building; hotel; inn; guesthouse
簡易	かんい	kani	simplicity; easiness; quasi-
感慨	かんがい	kangai	strong feelings; deep emotion
寒気	かんき	kanki	cold; frost; chill
簡潔	かんけつ	kanketsu	brevity; conciseness; simplicity
還元	かんげん	kangen	resolution; reduction; return to origins
刊行	かんこう	kankou	publication; issue
慣行	かんこう	kankou	customary practice; habit; traditional event
勧告	かんこく	kankoku	advice; counsel; remonstrance; recommendation
看護	かんご	kango	nursing; (army) nurse
漢語	かんご	kango	Chinese word; Sino-Japanese word
換算	かんさん	kansan	conversion; change; exchange
監視	かんし	kanshi	observation; guarding; inspection; surveillance
慣習	かんしゅう	kanshuu	usual (historical) custom
観衆	かんしゅう	kanshuu	spectators; onlookers; members of the audience
干渉	かんしょう	kanshou	interference; intervention
感触	かんしょく	kanshoku	sense of touch; feeling; sensation
肝心	かんじん	kanjin	essential; fundamental; crucial; vital; main
歓声	かんせい	kansei	cheer; shout of joy
感染	かんせん	kansen	infection; contagion
幹線	かんせん	kansen	main line; trunk line
関税	かんぜい	kanzei	customs; duty; tariff
簡素	かんそ	kanso	simplicity; plain
観点	かんてん	kanten	point of view
感度	かんど	kando	sensitivity; severity (quake)
幹部	かんぶ	kanbu	management; (executive) staff; leaders
勘弁	かんべん	kanben	pardon; forgiveness; forbearance
完璧	かんぺき	kanpeki	perfection; completeness; flawless
感無量	かんむりょう	kanmuryou	deep feeling; inexpressible feeling; filled with emotion
勧誘	かんゆう	kanyuu	invitation; solicitation; canvassing; inducement; persuasion; encouragement
関与	かんよ	kanyo	participation; taking part in; participating in; being concerned in
慣用	かんよう	kanyou	common; customary
寛容	かんよう	kanyou	forbearance; tolerance; generosity
観覧	かんらん	kanran	viewing
官僚	かんりょう	kanryou	bureaucrat; bureaucracy
慣例	かんれい	kanrei	custom; precedent; of convention
還暦	かんれき	kanreki	60th birthday
貫禄	かんろく	kanroku	presence; dignity
緩和	かんわ	kanwa	relief; mitigation
蓋	がい	gai	cover; lid; cap
街	がい	gai	~street; ~quarters
外貨	がいか	gaika	imported goods; foreign money
外観	がいかん	gaikan	appearance; exterior; facade
外相	がいしょう	gaishou	Foreign Minister
害する	がいする	gaisuru	to injure; to damage; to harm; to kill; to hinder
概説	がいせつ	gaisetsu	general statement; outline
該当	がいとう	gaitou	corresponding; answering to; coming under
街頭	がいとう	gaitou	in the street
概念	がいねん	gainen	general idea; concept; notion
外来	がいらい	gairai	imported; outpatient clinic
概略	がいりゃく	gairyaku	outline; summary; gist; in brief
学芸	がくげい	gakugei	arts and sciences; liberal arts
学士	がくし	gakushi	university graduate
学説	がくせつ	gakusetsu	theory
楽譜	がくふ	gakufu	score (music)
学歴	がくれき	gakureki	academic background
崖	がけ	gake	cliff
雅致	がち	gachi	artistry; good taste; elegance; grace
	がっくり	gakkuri	heartbroken
合唱	がっしょう	gasshou	chorus; singing in a chorus
	がっしり	gasshiri	firmly; solidly; tough
合致	がっち	gacchi	agreement; concurrence; conforming to
	がっちり	gacchiri	solidly built; tightly; shrewd; calculating
月日	がっぴ	gappi	(the) date
合併	がっぺい	gappei	combination; union; amalgamation; consolidation; merger; coalition; fusion; annexation; affiliation; incorpor
	がる	garu	feel
側	がわ	gawa	side; row; surroundings; part; (watch) case
癌	がん	gan	cancer
眼科	がんか	ganka	ophthalmology
眼球	がんきゅう	gankyuu	eyeball
眼鏡	がんきょう	gankyou	spectacles; glasses
頑固	がんこ	ganko	stubbornness; obstinacy
願書	がんしょ	gansho	written application or petition
頑丈	がんじょう	ganjou	solid; firm; stout; burly; strong; sturdy
岩石	がんせき	ganseki	rock
元年	がんねん	gannen	first year (of a specific reign)
贋物	がんぶつ	ganbutsu	imitation; counterfeit; forgery; sham
元来	がんらい	ganrai	originally; primarily; essentially; logically; naturally
生	き	ki	pure; undiluted; raw; crude
期	き	ki	period; time
企画	きかく	kikaku	planning; project
規格	きかく	kikaku	standard; norm
着飾る	きかざる	kikazaru	to dress up
器官	きかん	kikan	organ (of body); instrument
季刊	きかん	kikan	quarterly (e.g. magazine)
危害	きがい	kigai	injury; harm; danger
気兼ね	きがね	kigane	hesitance; diffidence; feeling constraint; fear of troubling someone; having scruples about doing someth
気軽	きがる	kigaru	cheerful; buoyant; lighthearted
危機	きき	kiki	crisis
聞き取り	ききとり	kikitori	listening comprehension
効き目	ききめ	kikime	effect; virtue; efficacy; impression
帰京	ききょう	kikyou	returning to Tokyo
基金	ききん	kikin	fund; foundation
棄権	きけん	kiken	abstain from voting; renunciation of a right
喜劇	きげき	kigeki	comedy; funny show
起源	きげん	kigen	origin; beginning; rise
機構	きこう	kikou	mechanism; organization
既婚	きこん	kikon	marriage; married
記載	きさい	kisai	mention; entry
気障	きざ	kiza	affectation; conceit; snobbery
兆(し)	きざし	kizashi	signs; omen; symptoms
軋む	きしむ	kishimu	to jar; to creak; to grate
気象	きしょう	kishou	weather; climate
期日	きじつ	kijitsu	fixed date; settlement date
記述	きじゅつ	kijutsu	describing; descriptor
奇数	きすう	kisuu	odd number
築く	きずく	kizuku	to build; to pile up; to amass
傷付く	きずつく	kizutsuku	to be hurt; to be wounded; to get injured
規制	きせい	kisei	regulation
汽船	きせん	kisen	steamship
寄贈	きそう	kisou	donation; presentation
貴族	きぞく	kizoku	noble; aristocrat
鍛える	きたえる	kitaeru	to forge; to drill; to temper; to train; to discipline
来る	きたる	kitaru	to come; to arrive; to be due to; to be next; to be forthcoming
気立て	きだて	kidate	disposition; nature
	きちっと	kichitto	exactly; perfectly
几帳面	きちょうめん	kichoumen	methodical; punctual; steady
切っ掛け	きっかけ	kikkake	chance; start; cue; excuse; motive; impetus; occasion
	きっかり	kikkari	exactly; precisely
喫茶	きっさ	kissa	tea drinking; tea house
	きっちり	kicchiri	precisely; tightly
屹度	きっと	kitto	1. (uk) surely; undoubtedly; certainly; without fail; 2. sternly; severely
	きっぱり	kippari	clearly; plainly; distinctly
規定	きてい	kitei	regulation; provisions
起点	きてん	kiten	starting point
軌道	きどう	kidou	orbit; railroad track
甲	きのえ	kinoe	1st in rank; first sign of the Chinese calendar; shell; instep; grade A
気配	きはい	kihai	indication; market trend; worry
規範	きはん	kihan	model; standard; pattern; norm; criterion; example
気品	きひん	kihin	aroma
気風	きふう	kifuu	character; traits; ethos
起伏	きふく	kifuku	undulation
規模	きぼ	kibo	scale; scope; plan; structure
気まぐれ	きまぐれ	kimagure	whim; caprice; whimsy; fickle; moody; uneven temper
生真面目	きまじめ	kimajime	too serious; person who is too serious; honesty; sincerity
期末	きまつ	kimatsu	end of term
決まり悪い	きまりわるい	kimariwarui	feeling awkward; being ashamed
決まる	きまる	kimaru	to be decided; to be settled; to look good in (clothes)
記名	きめい	kimei	signature; register
脚色	きゃくしょく	kyakushoku	dramatization (e.g. film)
脚本	きゃくほん	kyakuhon	scenario
客観	きゃっかん	kyakkan	objective
規約	きやく	kiyaku	agreement; rules; code
救援	きゅうえん	kyuuen	relief; rescue; reinforcement
休学	きゅうがく	kyuugaku	temporary absence from school; suspension
究極	きゅうきょく	kyuukyoku	ultimate; final; eventual
窮屈	きゅうくつ	kyuukutsu	narrow; tight; stiff; rigid; uneasy; formal; constrained
球根	きゅうこん	kyuukon	(plant) bulb
救済	きゅうさい	kyuusai	relief; aid; rescue; salvation; help
給食	きゅうしょく	kyuushoku	school lunch; providing a meal
給仕	きゅうじ	kyuuji	office boy (girl); page; waiter
休戦	きゅうせん	kyuusen	truce; armistice
旧知	きゅうち	kyuuchi	old friend; old friendship
宮殿	きゅうでん	kyuuden	palace
窮乏	きゅうぼう	kyuubou	poverty
丘陵	きゅうりょう	kyuuryou	hill
共	きょう	kyou	both; neither (neg); all; and; as well as; including; with; together with; plural ending
供	きょう	kyou	offer; present; submit; serve (a meal); supply
驚異	きょうい	kyoui	wonder; miracle
教員	きょういん	kyouin	teaching staff
教科	きょうか	kyouka	subject; curriculum
協会	きょうかい	kyoukai	association; society; organization
共感	きょうかん	kyoukan	sympathy; response
共学	きょうがく	kyougaku	coeducation
協議	きょうぎ	kyougi	conference; consultation; discussion; negotiation
教訓	きょうくん	kyoukun	lesson; precept; moral instruction
境遇	きょうぐう	kyouguu	environment; circumstances
強行	きょうこう	kyoukou	forcing; enforcement
強硬	きょうこう	kyoukou	firm; vigorous; unbending; unyielding; strong; stubborn
凶作	きょうさく	kyousaku	bad harvest; poor crop
共産	きょうさん	kyousan	communism
教材	きょうざい	kyouzai	teaching materials
教習	きょうしゅう	kyoushuu	training; instruction
郷愁	きょうしゅう	kyoushuu	nostalgia; homesickness
教職	きょうしょく	kyoushoku	teaching certificate; the teaching profession
享受	きょうじゅ	kyouju	reception; acceptance; enjoyment; being given
興じる	きょうじる	kyoujiru	to amuse oneself; to make merry
強制	きょうせい	kyousei	obligation; coercion; compulsion; enforcement
共存	きょうそん	kyouson	coexistence
姉妹	きょうだい	kyoudai	sisters
協調	きょうちょう	kyouchou	co-operation; conciliation; harmony; firm (market) tone
協定	きょうてい	kyoutei	arrangement; pact; agreement
脅迫	きょうはく	kyouhaku	threat; menace; coercion; terrorism
共鳴	きょうめい	kyoumei	resonance; sympathy
郷里	きょうり	kyouri	birth-place; home town
強烈	きょうれつ	kyouretsu	strong; intense; severe
共和	きょうわ	kyouwa	republicanism; cooperation
曲	きょく	kyoku	tune; piece of music
局限	きょくげん	kyokugen	limit; localize
極端	きょくたん	kyokutan	extreme; extremity
居住	きょじゅう	kyojuu	residence
拒絶	きょぜつ	kyozetsu	refusal; rejection
拒否	きょひ	kyohi	denial; veto; rejection; refusal
許容	きょよう	kyoyou	permission; pardon
距離	きょり	kyori	distance; range
寄与	きよ	kiyo	contribution; service
清らか	きよらか	kiyoraka	clean; pure; chaste
気楽	きらく	kiraku	at ease; comfortable
煌びやか	きらびやか	kirabiyaka	gorgeous; gaudy; dazzling; gay
切り	きり	kiri	limits; end; bounds; period; place to leave off; closing sentence; all there is; only; since
桐	きり	kiri	paulownia tree
切り替える	きりかえる	kirikaeru	to change; to exchange; to convert; to renew; to throw a switch; to replace; to switch over
気流	きりゅう	kiryuu	atmospheric current
奇麗	きれい	kirei	pretty; clean; nice; tidy; beautiful; fair
切れ目	きれめ	kireme	break; pause; gap; end; rift; interruption; cut; section; notch; incision; end (of a task)
際	きわ	kiwa	edge; brink; verge; side
木綿	きわた	kiwata	cotton
極めて	きわめて	kiwamete	exceedingly; extremely
僅	きん	kin	a little; small quantity
近眼	きんがん	kingan	nearsightedness; shortsightedness; myopia
緊急	きんきゅう	kinkyuu	urgent; pressing; emergency
近々	きんきん	kinkin	nearness; before long
近郊	きんこう	kinkou	suburbs; outskirts
均衡	きんこう	kinkou	equilibrium; balance
近視	きんし	kinshi	shortsightedness
禁じる	きんじる	kinjiru	to prohibit
禁ずる	きんずる	kinzuru	to forbid; to suppress
勤勉	きんべん	kinben	industry; diligence
勤務	きんむ	kinmu	service; duty; work
禁物	きんもつ	kinmotsu	taboo; forbidden thing
勤労	きんろう	kinrou	labor; exertion; diligent service
議案	ぎあん	gian	legislative bill
戯曲	ぎきょく	gikyoku	play; drama
議決	ぎけつ	giketsu	resolution; decision; vote
議事堂	ぎじどう	gijidou	Diet building
犠牲	ぎせい	gisei	sacrifice
偽造	ぎぞう	gizou	forgery; falsification; fabrication; counterfeiting
議題	ぎだい	gidai	topic of discussion; agenda
技能	ぎのう	ginou	technical skill; ability; capacity
逆転	ぎゃくてん	gyakuten	(sudden) change; reversal; turn-around; coming from behind (baseball)
行	ぎょう	gyou	line; row; verse
業者	ぎょうしゃ	gyousha	trader; merchant
行政	ぎょうせい	gyousei	administration
業績	ぎょうせき	gyouseki	achievement; performance; results; work; contribution
業務	ぎょうむ	gyoumu	business; affairs; duties; work
玉	ぎょく	gyoku	king (shogi)
漁船	ぎょせん	gyosen	fishing boat
漁村	ぎょそん	gyoson	fishing village
義理	ぎり	giri	duty; sense of duty; honor; decency; courtesy; debt of gratitude; social obligation
疑惑	ぎわく	giwaku	doubt; misgivings; distrust; suspicion
吟味	ぎんみ	ginmi	testing; scrutiny; careful investigation
区	く	ku	ward; district; section
食い違う	くいちがう	kuichigau	to cross each other; to run counter to; to differ; to clash; to go awry
空腹	くうふく	kuufuku	hunger
区画	くかく	kukaku	division; section; compartment; boundary; area; block
区間	くかん	kukan	section (of track etc)
茎	くき	kuki	stalk
区切り	くぎり	kugiri	an end; a stop; punctuation
潜る	くぐる	kuguru	1. to drive; to pass through; 2. to evade; to hide; 3. to dive (into or under water); to go undergro
種々	くさぐさ	kusagusa	variety
嚏	くしゃみ	kushami	sneeze
旧事	くじ	kuji	past events; bygones
籤引	くじびき	kujibiki	lottery; drawn lot
擽ぐったい	くすぐったい	kusuguttai	ticklish
草臥れる	くたびれる	kutabireru	to get tired; to wear out
下らない	くだらない	kudaranai	good-for-nothing; stupid; trivial; worthless
件	くだん	kudan	example; precedent; the usual; the said; the above-mentioned; (man) in question
口ずさむ	くちずさむ	kuchizusamu	to hum something; to sing to oneself
嘴	くちばし	kuchibashi	beak; bill
朽ちる	くちる	kuchiru	to rot
	くっきり	kukkiri	distinctly; clearly; boldly
屈折	くっせつ	kussetsu	bending; indentation; refraction
くっ付く	くっつく	kuttsuku	to adhere to; to keep close to
くっ付ける	くっつける	kuttsukeru	to attach
覆す	くつがえす	kutsugaesu	to overturn; to upset; to overthrow; to undermine
諄い	くどい	kudoi	verbose; importunate; heavy (taste)
国境	くにざかい	kunizakai	national or state border
首飾り	くびかざり	kubikazari	necklace
首輪	くびわ	kubiwa	necklace; choker
組み合わせ	くみあわせ	kumiawase	combination
組み合わせる	くみあわせる	kumiawaseru	to join together; to combine; to join up
組み込む	くみこむ	kumikomu	to insert; to include; to cut in (printing)
蔵	くら	kura	warehouse; cellar; magazine; granary; godown; depository; treasury; elevator
苦しめる	くるしめる	kurushimeru	to torment; to harass; to inflict pain
包む	くるむ	kurumu	to be engulfed in; to be enveloped by; to wrap up; to tuck in; to pack; to do up; to cover with; to dress i
呉れ呉れも	くれぐれも	kureguremo	repeatedly; sincerely; earnestly
呉れる	くれる	kureru	to give; to let one have; to do for one; to be given
玄人	くろうと	kurouto	expert; professional; geisha; prostitute
黒字	くろじ	kuroji	balance (figure) in the black
君主	くんしゅ	kunshu	ruler; monarch
愚痴	ぐち	guchi	idle complaint; grumble
	ぐっと	gutto	firmly; fast; much; more
	ぐらい	gurai	approximately
群	ぐん	gun	group (math)
軍艦	ぐんかん	gunkan	warship; battleship
群集	ぐんしゅう	gunshuu	(social) group; crowd; throng; mob; multitude
軍事	ぐんじ	gunji	military affairs
軍備	ぐんび	gunbi	armaments; military preparations
軍服	ぐんぷく	gunpuku	military or naval uniform
刑	けい	kei	penalty; sentence; punishment
頃	けい	kei	time; about; toward; approximately (time)
傾	けい	kei	lean; incline
系	けい	kei	system; lineage; group
経過	けいか	keika	passage; expiration; progress
軽快	けいかい	keikai	rhythmical (e.g. melody); casual (e.g. dress); light; nimble
警戒	けいかい	keikai	warning; admonition; vigilance
計器	けいき	keiki	meter; gauge
契機	けいき	keiki	opportunity; chance
敬具	けいぐ	keigu	Sincerely yours
軽減	けいげん	keigen	abatement
掲載	けいさい	keisai	appearance (e.g. article in paper)
傾斜	けいしゃ	keisha	inclination; slant; slope; bevel; list; dip
形成	けいせい	keisei	formation
形勢	けいせい	keisei	condition; situation; prospects
軽率	けいそつ	keisotsu	rash; thoughtless; careless; hasty
携帯	けいたい	keitai	carrying something
形態	けいたい	keitai	form; shape; figure
刑罰	けいばつ	keibatsu	judgement; penalty; punishment
経費	けいひ	keihi	expenses; cost; outlay
警部	けいぶ	keibu	police inspector
軽蔑	けいべつ	keibetsu	scorn; disdain
経歴	けいれき	keireki	personal history; career
経路	けいろ	keiro	course; route; channel
汚す	けがす	kegasu	to disgrace; to dishonour
汚らわしい	けがらわしい	kegarawashii	filthy; unfair
汚れ	けがれ	kegare	uncleanness; impurity; disgrace
汚れる	けがれる	kegareru	to get dirty; to become dirty
獣	けだもの	kedamono	beast; brute
吝嗇	けち	kechi	stinginess; miser; miserliness; skinflint; tightwad; niggard; pinching pennies
結核	けっかく	kekkaku	tuberculosis; tubercule
血管	けっかん	kekkan	blood vessel
決行	けっこう	kekkou	doing (with resolve); carrying out (i.e. a plan)
決算	けっさん	kessan	balance sheet; settlement of accounts
決勝	けっしょう	kesshou	decision of a contest; finals (in sports)
結晶	けっしょう	kesshou	crystal; crystallization
結成	けっせい	kessei	formation
結束	けっそく	kessoku	union; unity
傑	けつ	ketsu	excellence
決意	けつい	ketsui	decision; determination
決議	けつぎ	ketsugi	resolution; vote; decision
結合	けつごう	ketsugou	combination; union
決断	けつだん	ketsudan	decision; determination
欠乏	けつぼう	ketsubou	want; shortage; famine
蹴飛ばす	けとばす	ketobasu	to kick away; to kick off; to kick (someone); to refuse; to reject
貶す	けなす	kenasu	to speak ill of
煙たい	けむたい	kemutai	smoky; feeling awkward
煙る	けむる	kemuru	to smoke (e.g. fire)
家来	けらい	kerai	retainer; retinue; servant
	けれど	keredo	but; however
圏	けん	ken	sphere; circle; range
権	けん	ken	authority; the right (to do something)
権威	けんい	keni	authority; power; influence
兼業	けんぎょう	kengyou	side line; second business
権限	けんげん	kengen	power; authority; jurisdiction
健在	けんざい	kenzai	in good health; well
懸賞	けんしょう	kenshou	offering prizes; winning; reward
検事	けんじ	kenji	public prosecutor
健全	けんぜん	kenzen	health; soundness; wholesome
見地	けんち	kenchi	point of view
賢明	けんめい	kenmei	wisdom; intelligence; prudence
倹約	けんやく	kenyaku	thrift; economy; frugality
兼用	けんよう	kenyou	multi-use; combined use; combination; serving two purposes
権力	けんりょく	kenryoku	power; authority; influence
劇団	げきだん	gekidan	troupe; theatrical company
激励	げきれい	gekirei	encouragement
月謝	げっしゃ	gessha	monthly tuition fee
	げっそり	gessori	being disheartened; losing weight
月賦	げっぷ	geppu	monthly installment
下痢	げり	geri	diarrhoea
原	げん	gen	original; primitive; primary; fundamental; raw
原形	げんけい	genkei	original form; base form
現行	げんこう	genkou	present; current; in operation
原作	げんさく	gensaku	original work
原子	げんし	genshi	atom
元首	げんしゅ	genshu	ruler; sovereign
原書	げんしょ	gensho	original document
減少	げんしょう	genshou	decrease; reduction; decline
現場	げんじょう	genjou	actual spot; scene; scene of the crime
元素	げんそ	genso	chemical element
原則	げんそく	gensoku	principle; general rule
現像	げんぞう	genzou	developing (film)
現地	げんち	genchi	actual place; local
限定	げんてい	gentei	limit; restriction
原点	げんてん	genten	origin (coordinates); starting point
原典	げんてん	genten	original (text)
減点	げんてん	genten	subtract; give a demerit
原爆	げんばく	genbaku	atomic bomb
原文	げんぶん	genbun	the text; original
厳密	げんみつ	genmitsu	strict; close
原油	げんゆ	genyu	crude oil
言論	げんろん	genron	discussion
故	こ	ko	the late (deceased)
戸	こ	ko	counter for houses
児	こ	ko	child; the young of animals
巨	こ	ko	big; large; great
恋する	こいする	koisuru	to fall in love with; to love
溝	こう	kou	10^38; hundred undecillion (American); hundred sextillion (British)
校	こう	kou	-school; proof
好意	こうい	koui	good will; favor; courtesy
行為	こうい	koui	act; deed; conduct
行員	こういん	kouin	bank clerk
交易	こうえき	koueki	trade; commerce
公演	こうえん	kouen	public performance
後悔	こうかい	koukai	regret; repentance
公開	こうかい	koukai	presenting to the public
航海	こうかい	koukai	sail; voyage
工学	こうがく	kougaku	engineering
皇居	こうきょ	koukyo	Imperial Palace
好況	こうきょう	koukyou	prosperous conditions; healthy economy
抗議	こうぎ	kougi	protest; objection
鉱業	こうぎょう	kougyou	mining industry
興業	こうぎょう	kougyou	industrial enterprise
高原	こうげん	kougen	tableland; plateau
煌々と	こうこうと	koukouto	brilliantly; brightly
考古学	こうこがく	koukogaku	archaeology
交互	こうご	kougo	mutual; reciprocal; alternate
工作	こうさく	kousaku	work; construction; handicraft; maneuvering
耕作	こうさく	kousaku	cultivation; farming
鉱山	こうざん	kouzan	mine (ore)
講習	こうしゅう	koushuu	short course; training
交渉	こうしょう	koushou	negotiations; discussions; connection
高尚	こうしょう	koushou	high; noble; refined; advanced
行進	こうしん	koushin	march; parade
香辛料	こうしんりょう	koushinryou	spices
口述	こうじゅつ	koujutsu	verbal statement
控除	こうじょ	koujo	subsidy; deduction
向上	こうじょう	koujou	elevation; rise; improvement; advancement; progress
降水	こうすい	kousui	rainfall; precipitation
洪水	こうずい	kouzui	flood
公然	こうぜん	kouzen	open (e.g. secret); public; official
抗争	こうそう	kousou	dispute; resistance
構想	こうそう	kousou	plan; plot; idea; conception
拘束	こうそく	kousoku	restriction; restraint
後退	こうたい	koutai	retreat; backspace (BS)
光沢	こうたく	koutaku	brilliance; polish; lustre; glossy finish (of photographs)
公団	こうだん	koudan	public corporation
好調	こうちょう	kouchou	favourable; promising; satisfactory; in good shape
口頭	こうとう	koutou	oral
講読	こうどく	koudoku	reading; translation
購読	こうどく	koudoku	subscription (e.g. magazine)
購入	こうにゅう	kounyuu	purchase; buy
公認	こうにん	kounin	official recognition; authorization; licence; accreditation
光熱費	こうねつひ	kounetsuhi	cost of fuel and light
荒廃	こうはい	kouhai	ruin
購買	こうばい	koubai	purchase; buy
好評	こうひょう	kouhyou	popularity; favorable reputation
交付	こうふ	koufu	delivering; furnishing (with copies)
降伏	こうふく	koufuku	capitulation; surrender; submission
興奮	こうふん	koufun	excitement; stimulation; agitation; arousal
公募	こうぼ	koubo	public appeal; public contribution
巧妙	こうみょう	koumyou	ingenious; skillful; clever; deft
公用	こうよう	kouyou	government business; public use; public expense
小売	こうり	kouri	retail
効率	こうりつ	kouritsu	efficiency
公立	こうりつ	kouritsu	public (institution)
小柄	こがら	kogara	short (build)
小切手	こぎって	kogitte	cheque; check
国産	こくさん	kokusan	domestic products
国定	こくてい	kokutei	state-sponsored; national
国土	こくど	kokudo	realm
告白	こくはく	kokuhaku	confession; acknowledgement
国防	こくぼう	kokubou	national defence
国有	こくゆう	kokuyuu	national ownership
国連	こくれん	kokuren	U.N.; United Nations
漕ぐ	こぐ	kogu	to row; to scull; to pedal
焦げ茶	こげちゃ	kogecha	black tea
個々	ここ	koko	individual; one by one
箇箇	ここ	koko	individual; separate
心地	ここち	kokochi	feeling; sensation; mood
心得	こころえ	kokoroe	knowledge; information
心掛け	こころがけ	kokorogake	readiness; intention; aim
心掛ける	こころがける	kokorogakeru	to bear in mind; to aim to do
志	こころざし	kokorozashi	will; intention; motive
志す	こころざす	kokorozasu	to plan; to intend; to aspire to; to set aims (sights on)
心強い	こころづよい	kokorozuyoi	heartening; reassuring
心細い	こころぼそい	kokorobosoi	helpless; forlorn; hopeless; unpromising; lonely; discouraging; disheartening
試み	こころみ	kokoromi	trial; experiment
試みる	こころみる	kokoromiru	to try; to test
快い	こころよい	kokoroyoi	pleasant; agreeable
凝らす	こごらす	kogorasu	to freeze; to congeal
凝る	こごる	kogoru	to congeal; to freeze
拵える	こしらえる	koshiraeru	to make; to manufacture
孤児	こじ	koji	orphan
拗れる	こじれる	kojireru	to get complicated; to grow worse
故人	こじん	kojin	the deceased; old friend
梢	こずえ	kozue	treetop
個性	こせい	kosei	individuality; personality; idiosyncrasy
戸籍	こせき	koseki	census; family register
小銭	こぜに	kozeni	coins; small change
固体	こたい	kotai	solid (body)
答え	こたえ	kotae	answer; response
火燵	こたつ	kotatsu	table with heater; (orig) charcoal brazier in a floor well
古代	こだい	kodai	ancient times
	こだわる	kodawaru	to fuss over; to be particular about; to be concerned about
誇張	こちょう	kochou	exaggeration
滑稽	こっけい	kokkei	funny; humorous; comical; laughable; ridiculous; joking
国交	こっこう	kokkou	diplomatic relations
骨董品	こっとうひん	kottouhin	curio
骨	こつ	kotsu	knack; skill
固定	こてい	kotei	fixation
事柄	ことがら	kotogara	matter; thing; affair; circumstance
悉く	ことごとく	kotogotoku	altogether; entirely
言伝	ことづて	kotozute	declaration; hearsay
殊に	ことに	kotoni	especially; above all
事によると	ことによると	kotoniyoruto	depending on the circumstances
孤独	こどく	kodoku	isolation; loneliness; solitude
粉々	こなごな	konagona	in very small pieces
此の	この	kono	this
この間	このあいだ	konoaida	the other day; lately; recently
この頃	このごろ	konogoro	recently
好ましい	このましい	konomashii	nice; likeable; desirable
個別	こべつ	kobetsu	particular case
零す	こぼす	kobosu	to spill
零れる	こぼれる	koboreru	to overflow; to spill
細やか	こまやか	komayaka	friendly
混む	こむ	komu	to be crowded
込める	こめる	komeru	to include; to put into
篭る	こもる	komoru	to seclude oneself; to be confined in; to be implied; to be stuffy
固有	こゆう	koyuu	characteristic; tradition; peculiar; inherent; eigen-
雇用	こよう	koyou	employment (long term); hire
暦	こよみ	koyomi	calendar; almanac
堪える	こらえる	koraeru	to bear; to stand; to endure; to put up with; to support; to withstand; to resist; to brave; to be fit for; t
孤立	こりつ	koritsu	isolation; helplessness
懲りる	こりる	koriru	to learn by experience; to be disgusted with
此れ	これ	kore	this
此れ等	これら	korera	these
魂	こん	kon	soul; spirit
根気	こんき	konki	patience; perseverance; energy
根拠	こんきょ	konkyo	basis; foundation
混血	こんけつ	konketsu	mixed race; mixed parentage
昆虫	こんちゅう	konchuu	insect; bug
根底	こんてい	kontei	root; basis; foundation
混同	こんどう	kondou	confusion; mixing; merger
根本	こんぽん	konpon	origin; source; foundation; root; base; principle
御	ご	go	go-; honourable
語彙	ごい	goi	vocabulary; glossary
濠	ごう	gou	moat
業	ごう	gou	Buddhist karma; actions committed in a former life
号	ごう	gou	number; issue
合意	ごうい	goui	agreement; consent; mutual understanding
合議	ごうぎ	gougi	consultation; conference
強気	ごうぎ	gougi	great; grand
合成	ごうせい	gousei	synthesis; composition; synthetic; composite; mixed; combined; compound
護衛	ごえい	goei	guard; convoy; escort
語句	ごく	goku	words; phrases
極楽	ごくらく	gokuraku	paradise
ご苦労様	ごくろうさま	gokurousama	Thank you very much for your....
語源	ごげん	gogen	word root; word derivation; etymology
誤差	ごさ	gosa	error
ご座います	ございます	gozaimasu	to be (polite); to exist
ご馳走	ごちそう	gochisou	feast; treating (someone)
ご馳走さま	ごちそうさま	gochisousama	feast
毎	ごと	goto	each respectively
碁盤	ごばん	goban	Go board
誤魔化す	ごまかす	gomakasu	to deceive; to falsify; to misrepresent
御免ください	ごめんください	gomenkudasai	May I come in?
御免なさい	ごめんなさい	gomennasai	I beg your pardon; excuse me
御覧なさい	ごらんなさい	gorannasai	(please) look; (please) try to do
佐	さ	sa	help
再	さい	sai	re-; again; repeated
差異	さい	sai	difference; disparity
歳	さい	sai	-years old
再会	さいかい	saikai	another meeting; meeting again; reunion
災害	さいがい	saigai	calamity; disaster; misfortune
細菌	さいきん	saikin	bacillus; bacterium; germ
細工	さいく	saiku	work; craftsmanship; tactics; trick
採掘	さいくつ	saikutsu	mining
採決	さいけつ	saiketsu	vote; roll call
再建	さいけん	saiken	rebuilding; reconstruction; rehabilitation
再現	さいげん	saigen	reappearance; reproduction; return; revival
採算	さいさん	saisan	profit
採集	さいしゅう	saishuu	collecting; gathering
再生	さいせい	saisei	playback; regeneration; resuscitation; return to life; rebirth; reincarnation; narrow escape; reclamation; r
最善	さいぜん	saizen	the very best
採択	さいたく	saitaku	adoption; selection; choice
再発	さいはつ	saihatsu	return; relapse; reoccurrence
栽培	さいばい	saibai	cultivation
細胞	さいぼう	saibou	cell (biology)
採用	さいよう	saiyou	use; adopt
遮る	さえぎる	saegiru	to interrupt; to intercept; to obstruct
囀る	さえずる	saezuru	to sing; to chirp; to twitter
冴える	さえる	saeru	to be clear; to be serene; to be cold; to be skillful
竿	さお	sao	rod; pole (e.g. for drying laundry)
栄える	さかえる	sakaeru	to prosper; to flourish
杯	さかずき	sakazuki	wine cups
逆立ち	さかだち	sakadachi	handstand; headstand
逆上る	さかのぼる	sakanoboru	to go back; to go upstream; to make retroactive
盛る	さかる	sakaru	to prosper; to flourish; to copulate (animals)
差額	さがく	sagaku	balance; difference; margin
下がる	さがる	sagaru	to hang down; to abate; to retire; to fall; to step back
一昨昨日	さきおととい	sakiototoi	two days before yesterday
先に	さきに	sakini	before; earlier than; ahead; beyond; away; previously; recently
詐欺	さぎ	sagi	fraud; swindle
作	さく	saku	a work; a harvest
策	さく	saku	plan; policy
柵	さく	saku	fence; paling
削減	さくげん	sakugen	cut; reduction; curtailment
錯誤	さくご	sakugo	mistake
作戦	さくせん	sakusen	military or naval operations; tactics; strategy
作物	さくぶつ	sakubutsu	literary work
叫び	さけび	sakebi	shout; scream; outcry
裂ける	さける	sakeru	to split; to tear; to burst
捧げる	ささげる	sasageru	to lift up; to give; to offer; to consecrate; to devote; to sacrifice; to dedicate
差し掛かる	さしかかる	sashikakaru	to come near to; to approach
指図	さしず	sashizu	instruction; mandate
差し出す	さしだす	sashidasu	to present; to submit; to tender; to hold out
差し支える	さしつかえる	sashitsukaeru	to interfere; to hinder; to become impeded
差し引く	さしひく	sashihiku	to deduct
些事	さじ	saji	something small or petty; trifle
授ける	さずける	sazukeru	to grant; to award; to teach
嘸	さぞ	sazo	I am sure; certainly; no doubt
定まる	さだまる	sadamaru	to become settled; to be fixed
定める	さだめる	sadameru	to decide; to establish; to determine
錯覚	さっかく	sakkaku	optical illusion; hallucination
早急	さっきゅう	sakkyuu	urgent
察する	さっする	sassuru	to guess; to sense; to presume; to judge; to sympathize with
	さっと	satto	quickly; suddenly
冊	さつ	satsu	counter for books
殺人	さつじん	satsujin	murder
偖	さて	sate	well; now; then
悟る	さとる	satoru	to attain enlightenment; to perceive; to understand; to discern
裁く	さばく	sabaku	to judge
錆び	さび	sabi	rust (colour)
左程	さほど	sahodo	(not) very; (not) much
様	さま	sama	Mr. or Mrs.; manner; kind; appearance
三味線	さみせん	samisen	three-stringed Japanese guitar; shamisen
然も	しかも	shikamo	moreover; besides; into the bargain; and … at that; also; too
作用	さよう	sayou	action; operation; effect; function
左様なら	さようなら	sayounara	good-bye
拐う	さらう	sarau	to carry off; to run away with; to kidnap; to abduct
爽やか	さわやか	sawayaka	fresh; refreshing; invigorating; clear; fluent; eloquent
障る	さわる	sawaru	to hinder; to interfere with; to affect; to do one harm; to be harmful to
酸	さん	san	acid
酸化	さんか	sanka	oxidation
山岳	さんがく	sangaku	mountains
産休	さんきゅう	sankyuu	maternity leave
桟橋	さんきょう	sankyou	wharf; bridge; jetty; pier
参議院	さんぎいん	sangiin	House of Councillors
産後	さんご	sango	postpartum; after childbirth
産出	さんしゅつ	sanshutsu	yield; produce
参照	さんしょう	sanshou	reference; consultation; consultation
参上	さんじょう	sanjou	calling on; visiting
賛成	さんせい	sansei	approval; agreement; support; favour
賛美	さんび	sanbi	praise; adoration; glorification
産婦人科	さんふじんか	sanfujinka	maternity and gynecology department
産物	さんぶつ	sanbutsu	product; result; fruit
山腹	さんぷく	sanpuku	hillside; mountainside
山脈	さんみゃく	sanmyaku	mountain range
財	ざい	zai	fortune; riches
財源	ざいげん	zaigen	source of funds; resources; finances
在庫	ざいこ	zaiko	stockpile; stock
財政	ざいせい	zaisei	economy; financial affairs
座談会	ざだんかい	zadankai	symposium; round-table discussion
雑貨	ざっか	zakka	miscellaneous goods; general goods; sundries
雑	ざつ	zatsu	rough; crude
雑談	ざつだん	zatsudan	chatting; idle talk
雑木	ざつぼく	zatsuboku	various kinds of small trees; assorted trees
座標	ざひょう	zahyou	coordinate(s)
残金	ざんきん	zankin	remaining money
残酷	ざんこく	zankoku	cruelty; harshness
残高	ざんだか	zandaka	(bank) balance; remainder
次	し	shi	order; sequence; times; next; below
仕上がり	しあがり	shiagari	finish; end; completion
仕上げ	しあげ	shiage	end; finishing touches; being finished
仕上げる	しあげる	shiageru	to finish up; to complete
明々後日	しあさって	shiasatte	two days after tomorrow
飼育	しいく	shiiku	breeding; raising; rearing
強いて	しいて	shiite	by force
強いる	しいる	shiiru	to force; to compel; to coerce
仕入れる	しいれる	shiireru	to lay in stock; to replenish stock; to procure
	しいんと	shiinto	silent (as the grave); (deathly) quiet
歯科	しか	shika	dentistry
資格	しかく	shikaku	qualifications; requirements; capabilities
視覚	しかく	shikaku	sense of sight; vision
仕掛け	しかけ	shikake	device; trick; mechanism; gadget; (small) scale; half finished; commencement; set up; challenge
仕掛ける	しかける	shikakeru	to commence; to lay (mines); to set (traps); to wage (war); to challenge
然し	しかし	shikashi	however; but
然しながら	しかしながら	shikashinagara	nevertheless; however
而も	しかも	shikamo	moreover; furthermore; nevertheless; and yet
市街	しがい	shigai	urban areas; the streets; town; city
指揮	しき	shiki	command; direction
色彩	しきさい	shikisai	colour; hue; tints
式場	しきじょう	shikijou	ceremonial hall; place of ceremony (e.g. marriage)
為来り	しきたり	shikitari	customs
頻りに	しきりに	shikirini	frequently; repeatedly; incessantly; eagerly
仕切る	しきる	shikiru	to partition; to divide; to mark off; to settle accounts; to toe the mark
資金	しきん	shikin	funds; capital
施行	しぎょう	shigyou	1. execution; enforcing; carrying out
	しくじる	shikujiru	to fail; to fall through; to blunder
仕組み	しくみ	shikumi	devising; plan; plot; contrivance; construction; arrangement
死刑	しけい	shikei	death penalty; capital punishment
湿気る	しける	shikeru	to be damp; to be moist
思考	しこう	shikou	thought
志向	しこう	shikou	intention; aim
嗜好	しこう	shikou	taste; liking; preference
視察	しさつ	shisatsu	inspection; observation
資産	しさん	shisan	property; fortune; means; assets
刺繍	ししゅう	shishuu	embroidery
支持	しじ	shiji	support; maintenance
指示	しじ	shiji	indication; instruction; directions
雫	しずく	shizuku	drop (of water)
沈める	しずめる	shizumeru	to sink; to submerge
施設	しせつ	shisetsu	institution; establishment; facility; (army) engineer
子息	しそく	shisoku	son
慕う	したう	shitau	to yearn for; to miss; to adore; to love dearly
従って	したがって	shitagatte	therefore; consequently; in accordance with
下心	したごころ	shitagokoro	secret intention; motive
親しむ	したしむ	shitashimu	to be intimate with; to befriend
下調べ	したしらべ	shitashirabe	preliminary investigation; preparation
下地	したじ	shitaji	groundwork; foundation; inclination; aptitude; elementary knowledge of; grounding in; prearrangement; spade
認める	したためる	shitatameru	to write up
仕立てる	したてる	shitateru	to tailor; to make; to prepare; to train; to send (a messenger)
下取り	したどり	shitadori	trade in; part exchange
下火	したび	shitabi	burning low; waning; declining
失格	しっかく	shikkaku	disqualification; elimination; incapacity (legal)
確り	しっかり	shikkari	firmly; tightly; reliable; level-headed; steady
質素	しっそ	shisso	simplicity; modesty; frugality
失調	しっちょう	shicchou	lack of harmony
嫉妬	しっと	shitto	jealousy
尻尾	しっぽ	shippo	tail (animal)
室	しつ	shitsu	room
質疑	しつぎ	shitsugi	question
躾	しつけ	shitsuke	home discipline; training; upbringing; breeding
仕付ける	しつける	shitsukeru	to be used to a job; to begin to do; to baste; to tack; to plant
指摘	してき	shiteki	pointing out; identification
視点	してん	shiten	opinion; point of view; visual point
萎びる	しなびる	shinabiru	to wilt; to fade
嫋か	しなやか	shinayaka	supple; flexible; elastic
屎尿	しにょう	shinyou	excreta; raw sewage; human waste; night soil
凌ぐ	しのぐ	shinogu	to outdo; to surpass; to endure; to keep out (rain); to stave off; to tide over; to pull through; to defy; t
始発	しはつ	shihatsu	first train
芝	しば	shiba	lawn; sod; turf
屡	しばしば	shibashiba	often; again and again; frequently
暫く	しばらく	shibaraku	little while
痺れる	しびれる	shibireru	to become numb; to go to sleep (i.e. a limb)
渋い	しぶい	shibui	1. tasteful (clothing); cool; an aura of refined masculinity; 2. astringent; sullen; bitter (taste); 3
私物	しぶつ	shibutsu	private property; personal effects
	しぶとい	shibutoi	tenacious; stubborn
司法	しほう	shihou	administration of justice
脂肪	しぼう	shibou	fat; grease; blubber
志望	しぼう	shibou	wish; desire; ambition
萎む	しぼむ	shibomu	to wither; to fade (away); to shrivel; to wilt
仕舞	しまい	shimai	end; termination; informal (Noh play)
仕舞う	しまう	shimau	to finish; to close; to do something completely; to put away; to put an end to
	しまった	shimatta	Damn it!
始末	しまつ	shimatsu	management; dealing; settlement; cleaning up afterwards
泌み泌み	しみじみ	shimijimi	keenly; deeply; heartily
染みる	しみる	shimiru	to pierce; to permeate
使命	しめい	shimei	mission; errand; message
締め切り	しめきり	shimekiri	closing; cut-off; end; deadline; Closed; No Entrance
僕	しもべ	shimobe	manservant; servant (of God)
社交	しゃこう	shakou	social life; social intercourse
謝絶	しゃぜつ	shazetsu	refusal
社宅	しゃたく	shataku	company owned house
吃逆	しゃっくり	shakkuri	hiccough; hiccup
喋る	しゃべる	shaberu	to talk; to chat; to chatter
斜面	しゃめん	shamen	slope; slanting surface; bevel
洒落	しゃらく	sharaku	frank; open-hearted
洒落る	しゃれる	shareru	to joke; to play on words; to dress stylishly
視野	しや	shiya	field of vision; outlook
種	しゅ	shu	kind; variety; species
衆	しゅう	shuu	masses; great number; the people
周	しゅう	shuu	circuit; lap; circumference; vicinity; Chou (dynasty)
収益	しゅうえき	shuueki	earnings; proceeds; returns
修学	しゅうがく	shuugaku	learning
周期	しゅうき	shuuki	cycle; period
衆議院	しゅうぎいん	shuugiin	Lower House; House of Representatives
就業	しゅうぎょう	shuugyou	employment; starting work
修行	しゅうぎょう	shuugyou	pursuit of knowledge; studying; learning; training; ascetic practice; discipline
集計	しゅうけい	shuukei	totalization; aggregate
襲撃	しゅうげき	shuugeki	attack; charge; raid
収支	しゅうし	shuushi	income and expenditure
終始	しゅうし	shuushi	beginning and end; from beginning to end; doing a thing from beginning to end
修士	しゅうし	shuushi	Masters degree program
収集	しゅうしゅう	shuushuu	gathering up; collection; accumulation
修飾	しゅうしょく	shuushoku	ornamentation; embellishment; decoration; adornment; polish up (writing); modification (gram)
終日	しゅうじつ	shuujitsu	all day
執着	しゅうじゃく	shuujaku	attachment; adhesion; tenacity
収容	しゅうよう	shuuyou	accommodation; reception; seating; housing; custody; admission; entering (in a dictionary)
修了	しゅうりょう	shuuryou	completion (of a course)
守衛	しゅえい	shuei	security guard; doorkeeper
主演	しゅえん	shuen	starring; playing the leading part
主観	しゅかん	shukan	subjectivity; subject; ego
祝賀	しゅくが	shukuga	celebration; congratulations
宿命	しゅくめい	shukumei	fate; destiny; predestination
主権	しゅけん	shuken	sovereignty; supremacy; dominion
手芸	しゅげい	shugei	handicrafts
主催	しゅさい	shusai	organization; sponsorship
取材	しゅざい	shuzai	choice of subject; collecting data
趣旨	しゅし	shushi	object; meaning
主食	しゅしょく	shushoku	staple food
主人公	しゅじんこう	shujinkou	protagonist; main character; hero(ine) (of a story); head of household
主体	しゅたい	shutai	subject; main constituent
主題	しゅだい	shudai	subject; theme; motif
出血	しゅっけつ	shukketsu	bleeding; haemorrhage
出産	しゅっさん	shussan	(child)birth; delivery; production (of goods)
出社	しゅっしゃ	shussha	arrival (in a country at work etc.)
出生	しゅっしょう	shusshou	birth
出世	しゅっせ	shusse	promotion; successful career; eminence
出費	しゅっぴ	shuppi	expenses; disbursements
出品	しゅっぴん	shuppin	exhibit; display
出演	しゅつえん	shutsuen	performance; stage appearance
出題	しゅつだい	shutsudai	proposing a question
出動	しゅつどう	shutsudou	sailing; marching; going out
主導	しゅどう	shudou	main leadership
主任	しゅにん	shunin	person in charge; responsible official
首脳	しゅのう	shunou	head; brains
守備	しゅび	shubi	defense
手法	しゅほう	shuhou	technique
私有	しゆう	shiyuu	private ownership
諸	しょ	sho	various; many; several
背負う	しょう	shou	to be burdened with; to carry on back or shoulder
象	しょう	shou	phenomenon
症	しょう	shou	illness
傷	しょう	shou	wound; injury; hurt; cut; gash; bruise; scratch; scar; weak point
商	しょう	shou	quotient
消去	しょうきょ	shoukyo	elimination; erasing; dying out; melting away
衝撃	しょうげき	shougeki	shock; crash; impact; ballistic
証言	しょうげん	shougen	evidence; testimony
証拠	しょうこ	shouko	evidence; proof
消耗	しょうこう	shoukou	exhaustion; consumption
照合	しょうごう	shougou	collation; comparison
詳細	しょうさい	shousai	detail; particulars
昇進	しょうしん	shoushin	promotion
少数	しょうすう	shousuu	minority; few
称する	しょうする	shousuru	to pretend; to take the name of; to feign; to purport
消息	しょうそく	shousoku	news; letter; circumstances
承諾	しょうだく	shoudaku	consent; acquiescence; agreement
象徴	しょうちょう	shouchou	symbol
小児科	しょうにか	shounika	pediatrics
証人	しょうにん	shounin	witness
照明	しょうめい	shoumei	illumination
勝利	しょうり	shouri	victory; triumph; conquest; success; win
奨励	しょうれい	shourei	encouragement; promotion; message; address
職員	しょくいん	shokuin	staff member; personnel
植民地	しょくみんち	shokuminchi	colony
職務	しょくむ	shokumu	professional duties
諸君	しょくん	shokun	Gentlemen!; Ladies!
所在	しょざい	shozai	whereabouts
所々	しょしょ	shosho	here and there; some parts (of something)
所持	しょじ	shoji	possession; owning
所属	しょぞく	shozoku	attached to; belong to
処置	しょち	shochi	treatment
	しょっちゅう	shocchuu	always; constantly
所定	しょてい	shotei	fixed; prescribed
所得	しょとく	shotoku	income; earnings
初版	しょはん	shohan	first edition
処罰	しょばつ	shobatsu	punishment
書評	しょひょう	shohyou	book review
処分	しょぶん	shobun	disposal; dealing; punishment
庶民	しょみん	shomin	masses; common people
庶務	しょむ	shomu	general affairs
私用	しよう	shiyou	personal use; private business
仕様	しよう	shiyou	way; method; resource; remedy; (technical) specification
使用人	しようにん	shiyounin	employee; servant
調べ	しらべ	shirabe	preparation; investigation; inspection
知り合い	しりあい	shiriai	acquaintance
退く	しりぞく	shirizoku	to retreat; to recede; to withdraw
退ける	しりぞける	shirizokeru	to repel; to drive away
記す	しるす	shirusu	to note; to write down
指令	しれい	shirei	orders; instructions; directive
代	しろ	shiro	price; materials; substitution
皺	しわ	shiwa	wrinkles; creases
新	しん	shin	new
進化	しんか	shinka	evolution; progress
殿	しんがり	shingari	rear; rear unit guard
審議	しんぎ	shingi	deliberation
進行	しんこう	shinkou	advance
新興	しんこう	shinkou	rising; developing; emergent
振興	しんこう	shinkou	promotion; encouragement
申告	しんこく	shinkoku	report; statement; filing a return; notification
新婚	しんこん	shinkon	newly-wed
審査	しんさ	shinsa	judging; inspection; examination; investigation
紳士	しんし	shinshi	gentleman
進出	しんしゅつ	shinshutsu	advance; step forward
信者	しんじゃ	shinja	believer; adherent; devotee; Christian
真珠	しんじゅ	shinju	pearl
心中	しんじゅう	shinjuu	double suicide; lovers suicide
心情	しんじょう	shinjou	mentality
新人	しんじん	shinjin	new face; newcomer
神聖	しんせい	shinsei	holiness; sacredness; dignity
親善	しんぜん	shinzen	friendship
真相	しんそう	shinsou	truth; real situation
新築	しんちく	shinchiku	new building; new construction
進呈	しんてい	shintei	presentation
進展	しんてん	shinten	progress; development
神殿	しんでん	shinden	temple; sacred place
進度	しんど	shindo	progress
振動	しんどう	shindou	oscillation; vibration
新入生	しんにゅうせい	shinnyuusei	freshman; first-year student
信任	しんにん	shinnin	trust; confidence; credence
審判	しんばん	shinban	refereeing; trial; judgement; umpire; referee
神秘	しんぴ	shinpi	mystery
辛抱	しんぼう	shinbou	patience; endurance
真理	しんり	shinri	truth
侵略	しんりゃく	shinryaku	aggression; invasion; raid
診療	しんりょう	shinryou	medical examination and treatment; diagnosis
進路	しんろ	shinro	course; route
自覚	じかく	jikaku	self-conscious
地方	じかた	jikata	area; locality; district; region; the coast
自我	じが	jiga	self; the ego
磁気	じき	jiki	magnetism
磁器	じき	jiki	porcelain; china
事業	じぎょう	jigyou	project; enterprise; business; industry; operations
地形	じぎょう	jigyou	terrain; geographical features; topography
軸	じく	jiku	axis; stem; shaft; axle
自己	じこ	jiko	self; oneself
事項	じこう	jikou	matter; item; facts
時刻表	じこくひょう	jikokuhyou	table; diagram; chart; timetable; schedule
地獄	じごく	jigoku	hell
時差	じさ	jisa	time difference
自在	じざい	jizai	freely; at will
自主	じしゅ	jishu	independence; autonomy
自首	じしゅ	jishu	surrender; give oneself up
辞職	じしょく	jishoku	resignation
自信	じしん	jishin	self-confidence
事前	じぜん	jizen	prior; beforehand; in advance
自尊心	じそんしん	jisonshin	self-respect; conceit
持続	じぞく	jizoku	continuation
字体	じたい	jitai	type; font; lettering
辞退	じたい	jitai	refusal
	じっくり	jikkuri	deliberately; carefully
実質	じっしつ	jisshitsu	substance; essence
実践	じっせん	jissen	practice; put into practice
実態	じったい	jittai	truth; fact
実費	じっぴ	jippi	actual expense; cost price
十分	じっぷん	jippun	10 minutes
実	じつ	jitsu	truth; reality; sincerity; fidelity; kindness; faith; substance; essence
実業家	じつぎょうか	jitsugyouka	industrialist; businessman
実情	じつじょう	jitsujou	real condition; actual circumstances; actual state of affairs
自転	じてん	jiten	rotation; spin
自動詞	じどうし	jidoushi	intransitive verb (no direct obj)
地主	じぬし	jinushi	landlord
耳鼻科	じびか	jibika	otolaryngology
地元	じもと	jimoto	local
弱	じゃく	jaku	weakness; the weak; little less then
若干	じゃっかん	jakkan	some; few; number of
砂利	じゃり	jari	gravel; ballast; pebbles
じゃん拳	じゃんけん	janken	rock-scissors-paper game
住	じゅう	juu	dwelling; living
従業員	じゅうぎょういん	juugyouin	employee; worker
従事	じゅうじ	juuji	engaging; pursuing; following
充実	じゅうじつ	juujitsu	fullness; completion; perfection; substantiality; enrichment
十字路	じゅうじろ	juujiro	crossroads
絨毯	じゅうたん	juutan	carpet
柔軟	じゅうなん	juunan	flexible; lithe
重複	じゅうふく	juufuku	duplication; repetition; overlapping; redundancy; restoration
重宝	じゅうほう	juuhou	priceless treasure; convenience; usefulness
従来	じゅうらい	juurai	up to now; so far; traditional
塾	じゅく	juku	coaching school; lessons
樹木	じゅもく	jumoku	trees and shrubs; arbour
樹立	じゅりつ	juritsu	establish; create
準急	じゅんきゅう	junkyuu	local express (train slower than an express)
準じる	じゅんじる	junjiru	to follow; to conform; to apply to
準ずる	じゅんずる	junzuru	to apply correspondingly; to correspond to; to be proportionate to; to conform to
助	じょ	jo	help; rescue; assistant
情	じょう	jou	feelings; emotion; passion
畳	じょう	jou	a mat
尉	じょう	jou	jailer; old man; rank; company officer
嬢	じょう	jou	young woman
状	じょう	jou	shape
上位	じょうい	joui	superior (rank not class); higher order (e.g. byte); host computer (of connected device)
上演	じょうえん	jouen	performance (e.g. music)
城下	じょうか	jouka	land near the castle
乗客	じょうかく	joukaku	passenger
上空	じょうくう	joukuu	sky; the skies; high-altitude sky; upper air
上司	じょうし	joushi	superior authorities; boss
情緒	じょうしょ	jousho	emotion; feeling
上昇	じょうしょう	joushou	rising; ascending; climbing
情勢	じょうせい	jousei	state of things; condition; situation
情熱	じょうねつ	jounetsu	passion; enthusiasm; zeal
丈夫	じょうふ	joufu	1. hero; gentleman; warrior; manly person; 2. good health; robustness; strong; solid; durable
譲歩	じょうほ	jouho	concession; conciliation; compromise
条約	じょうやく	jouyaku	treaty; pact
上陸	じょうりく	jouriku	landing; disembarkation
蒸留	じょうりゅう	jouryuu	distillation
除外	じょがい	jogai	exception; exclusion
助言	じょげん	jogen	advice; suggestion
徐行	じょこう	jokou	going slowly
女史	じょし	joshi	Ms.
助詞	じょし	joshi	particle; postposition
助動詞	じょどうし	jodoushi	auxiliary verb
自立	じりつ	jiritsu	independence; self-reliance
人	じん	jin	man; person; people
人格	じんかく	jinkaku	personality; character; individuality
人材	じんざい	jinzai	man of talent
迅速	じんそく	jinsoku	quick; fast; rapid; swift; prompt
人体	じんたい	jintai	human body
人民	じんみん	jinmin	people; public
人目	じんもく	jinmoku	glimpse; public gaze
水気	すいき	suiki	1. moisture; dampness; vapor; 2. dropsy; edema
水源	すいげん	suigen	source of river; fountainhead
推進	すいしん	suishin	propulsion; driving force
水洗	すいせん	suisen	flushing
吹奏	すいそう	suisou	playing wind instruments
推測	すいそく	suisoku	guess; conjecture
水田	すいでん	suiden	(water-filled) paddy field
推理	すいり	suiri	reasoning; inference; mystery or detective genre (movie novel etc.)
数詞	すうし	suushi	numeral
崇拝	すうはい	suuhai	worship; adoration; admiration; cult
据え付ける	すえつける	suetsukeru	to install; to equip; to mount
据える	すえる	sueru	to set (table); to lay (foundation); to place (gun); to apply (moxa)
清々しい	すがすがしい	sugasugashii	fresh; refreshing
過ぎ	すぎ	sugi	past; after
救い	すくい	sukui	help; aid; relief
掬う	すくう	sukuu	to scoop; to ladle out
少なくとも	すくなくとも	sukunakutomo	at least
直ぐ	すぐ	sugu	immediately; soon; easily; right (near); honest; upright
健やか	すこやか	sukoyaka	vigorous; healthy; sound
濯ぐ	すすぐ	susugu	to rinse; to wash out
進み	すすみ	susumi	progress
勧め	すすめ	susume	recommendation; advice; encouragement
裾	すそ	suso	(trouser) cuff; (skirt) hem; cut edge of a hairdo; foot of mountain
廃れる	すたれる	sutareru	to go out of use; to become obsolete; to die out; to go out of fashion
酸っぱい	すっぱい	suppai	sour; acid
素敵	すてき	suteki	lovely; dreamy; beautiful; great; fantastic; superb; cool; capital
即ち	すなわち	sunawachi	that is; namely; i.e.
	すばしこい	subashikoi	nimble; smart; quick
素早い	すばやい	subayai	fast; quick; prompt; agile
済ます	すます	sumasu	to finish; to get it over with; to settle; to conclude; to pay back
澄ます	すます	sumasu	to clear; to make clear; to be unruffled; to look unconcerned; to look demure; look prim; put on airs
済まない	すまない	sumanai	sorry (phrase)
済みません	すみません	sumimasen	sorry; excuse me
天皇	すめらぎ	sumeragi	Emperor of Japan
刷り	すり	suri	printing
剃る	する	suru	to shave
擦れ違い	すれちがい	surechigai	chance encounter
すれ違う	すれちがう	surechigau	to pass by one another; to disagree; to miss each other
擦れる	すれる	sureru	to rub; to chafe; to wear; to become sophisticated
	すんなり	sunnari	pass with no objection; slim; slender
図々しい	ずうずうしい	zuuzuushii	impudent; shameless
	ずばり	zubari	decisively; decidedly; once and for all; unreservedly; frankly
ずぶ濡れ	ずぶぬれ	zubunure	soaked; dripping wet
	ずらっと	zuratto	in a line; in a row
	ずるずる	zuruzuru	sound or act of dragging; loose; inconclusive but unwanted situation; trailingly
	ずれ	zure	gap; slippage
	ずれる	zureru	to slide; to slip off
制	せい	sei	system; organization; imperial command; laws; regulation; control; government; suppression; restraint; holdin
製	せい	sei	-made; make
生育	せいいく	seiiku	growth; development; breeding
成果	せいか	seika	results; fruits
正解	せいかい	seikai	correct; right; correct interpretation (answer solution)
正規	せいき	seiki	regular; legal; formal; established; legitimate
正義	せいぎ	seigi	justice; right; righteousness; correct meaning
生計	せいけい	seikei	livelihood; living
政権	せいけん	seiken	administration; political power
精巧	せいこう	seikou	elaborate; delicate; exquisite
制裁	せいさい	seisai	restraint; sanctions; punishment
政策	せいさく	seisaku	political measures; policy
清算	せいさん	seisan	liquidation; settlement
星座	せいざ	seiza	constellation
生死	せいし	seishi	life and death
静止	せいし	seishi	stillness; repose; standing still
青春	せいしゅん	seishun	youth; springtime of life; adolescent
聖書	せいしょ	seisho	Bible; scriptures
誠実	せいじつ	seijitsu	sincere; honest; faithful
成熟	せいじゅく	seijuku	maturity; ripeness
清純	せいじゅん	seijun	purity; innocence
正常	せいじょう	seijou	normalcy; normality; normal
制する	せいする	seisuru	to control; to command; to get the better of
整然	せいぜん	seizen	orderly; regular; well-organized; trim; accurate
盛装	せいそう	seisou	be dressed up; wear rich clothes
盛大	せいだい	seidai	grand; prosperous; magnificent
清濁	せいだく	seidaku	good and evil; purity and impurity
制定	せいてい	seitei	enactment; establishment; creation
静的	せいてき	seiteki	static
製鉄	せいてつ	seitetsu	iron manufacture
晴天	せいてん	seiten	fine weather
正当	せいとう	seitou	just; justifiable; right; due; proper; equitable; reasonable; legitimate; lawful
成年	せいねん	seinen	majority; adult age
制服	せいふく	seifuku	uniform
征服	せいふく	seifuku	conquest; subjugation; overcoming
製法	せいほう	seihou	manufacturing method; recipe; formula
精密	せいみつ	seimitsu	precise; exact; detailed; minute; close
声明	せいめい	seimei	declaration; statement; proclamation
姓名	せいめい	seimei	full name
制約	せいやく	seiyaku	limitation; restriction; condition; constraints
生理	せいり	seiri	physiology; menses
勢力	せいりょく	seiryoku	influence; power; might; strength; potency; force; energy
整列	せいれつ	seiretsu	stand in a row; form a line
急かす	せかす	sekasu	to hurry; to urge on
伜	せがれ	segare	son; my son
責務	せきむ	sekimu	duty; obligation
世辞	せじ	seji	flattery; compliment
世帯	せたい	setai	household
世代	せだい	sedai	generation; the world; the age
切開	せっかい	sekkai	clearing (land); opening up; cutting through
接触	せっしょく	sesshoku	touch; contact
設置	せっち	secchi	establishment; institution
折衷	せっちゅう	secchuu	compromise; cross; blending; eclecticism
設定	せってい	settei	establishment; creation
説得	せっとく	settoku	persuasion
節	せつ	setsu	node; section; occasion; time
切実	せつじつ	setsujitsu	compelling; serious; severe; acute; earnest; pressing; urgent
接続詞	せつぞくし	setsuzokushi	conjunction
切ない	せつない	setsunai	painful; trying; oppressive; suffocating
設立	せつりつ	setsuritsu	establishment; foundation; institution
攻め	せめ	seme	attack; offence
世論	せろん	seron	public opinion
仙	せん	sen	hermit; wizard
前	せん	sen	before
繊維	せんい	seni	fibre; fiber; textile
選挙	せんきょ	senkyo	election
宣教	せんきょう	senkyou	religious mission
宣言	せんげん	sengen	declaration; proclamation; announcement
先行	せんこう	senkou	preceding; going first
選考	せんこう	senkou	selection; screening
戦災	せんさい	sensai	war damage
専修	せんしゅう	senshuu	specialization
戦術	せんじゅつ	senjutsu	tactics
潜水	せんすい	sensui	diving
先先月	せんせんげつ	sensengetsu	month before last
先先週	せんせんしゅう	sensenshuu	week before last
先代	せんだい	sendai	family predecessor; previous age; previous generation
先だって	せんだって	sendatte	recently; the other day
先着	せんちゃく	senchaku	first arrival
先天的	せんてんてき	sententeki	a priori; inborn; innate; inherent; congenital; hereditary
戦闘	せんとう	sentou	battle; fight; combat
潜入	せんにゅう	sennyuu	infiltration; sneaking in
船舶	せんぱく	senpaku	ship
専用	せんよう	senyou	exclusive use; personal use
占領	せんりょう	senryou	occupation; capture; possession; have a room to oneself
戦力	せんりょく	senryoku	war potential
税務署	ぜいむしょ	zeimusho	tax office
是正	ぜせい	zesei	correction; revision
絶版	ぜっぱん	zeppan	out of print
絶望	ぜつぼう	zetsubou	despair; hopelessness
是非とも	ぜひとも	zehitomo	by all means (with sense of not taking no for an answer)
膳	ぜん	zen	(small) table; tray; meal
禅	ぜん	zen	Zen (Buddhism)
全快	ぜんかい	zenkai	complete recovery of health
全盛	ぜんせい	zensei	height of prosperity
前提	ぜんてい	zentei	preamble; premise; reason; prerequisite
前途	ぜんと	zento	future prospects; outlook; the journey ahead
全滅	ぜんめつ	zenmetsu	annihilation
善良	ぜんりょう	zenryou	goodness; excellence; virtue
前例	ぜんれい	zenrei	precedent
僧	そう	sou	monk; priest
沿う	そう	sou	to run along; to follow
添う	そう	sou	to accompany; to become married; to comply with
総	そう	sou	whole; all; general; gross
相応	そうおう	souou	suitability; fitness
総会	そうかい	soukai	general meeting
創刊	そうかん	soukan	launching (e.g. newspaper); first issue
送金	そうきん	soukin	remittance; sending money
走行	そうこう	soukou	running a wheeled vehicle (e.g. car); traveling
総合	そうごう	sougou	synthesis; coordination; putting together; integration; composite
捜査	そうさ	sousa	search (esp. in criminal investigations); investigation
捜索	そうさく	sousaku	search (esp. for someone or something missing); investigation
然うして	そうして	soushite	and; like that
装飾	そうしょく	soushoku	ornament
操縦	そうじゅう	soujuu	management; handling; control; manipulation
創造	そうぞう	souzou	creation
壮大	そうだい	soudai	magnificent; grand; majestic; splendid
騒動	そうどう	soudou	strife; riot; rebellion
遭難	そうなん	sounan	disaster; shipwreck; accident
相場	そうば	souba	market price; speculation; estimation
装備	そうび	soubi	equipment
創立	そうりつ	souritsu	establishment; founding; organization
添える	そえる	soeru	to add to; to attach; to append; to accompany; to garnish; to imitate; to annex
即座に	そくざに	sokuzani	immediately; right away
促進	そくしん	sokushin	promotion; acceleration; encouragement; facilitation; spurring on
即する	そくする	sokusuru	to conform to; to agree with; to be adapted to; to be based on
束縛	そくばく	sokubaku	restraint; shackles; restriction; confinement; binding
側面	そくめん	sokumen	side; flank; sidelight; lateral
其処	そこ	soko	that place; there
其処で	そこで	sokode	so (conj); accordingly; now; then; thereupon
損なう	そこなう	sokonau	to harm; to hurt; to injure; to damage; to fail in doing
其処ら	そこら	sokora	everywhere; somewhere; approximately; that area; around there
素材	そざい	sozai	raw materials; subject matter
阻止	そし	soshi	obstruction; check; hindrance; prevention; interdiction
然して	そして	soshite	and
訴訟	そしょう	soshou	litigation; lawsuit
育ち	そだち	sodachi	breeding; growth
措置	そち	sochi	measure; step
其方	そちら	sochira	over there; the other
素っ気ない	そっけない	sokkenai	cold; short; curt; blunt
率直	そっちょく	socchoku	frankness; candour; openheartedness
外方	そっぽ	soppo	look (or turn) the other way
備え付ける	そなえつける	sonaetsukeru	to provide; to furnish; to equip; to install
備わる	そなわる	sonawaru	to be furnished with; to be endowed with; to possess; to be among; to be one of; to be possessed of
園	その	sono	garden; park; plantation
その上	そのうえ	sonoue	in addition; furthermore
その内	そのうち	sonouchi	eventually; sooner or later; of the previously mentioned
その為	そのため	sonotame	hence; for that reason
その外	そのほか	sonohoka	besides; in addition; the rest
其の儘	そのまま	sonomama	without change; as it is (i.e. now)
聳える	そびえる	sobieru	to rise; to tower; to soar
素朴	そぼく	soboku	simplicity; artlessness; naivete
染まる	そまる	somaru	to dye
背く	そむく	somuku	to run counter to; to go against; to disobey; to infringe
染める	そめる	someru	to dye; to colour
逸らす	そらす	sorasu	to turn away; to avert
反り	そり	sori	warp; curvature; curve; arch
其れ	それ	sore	it; that
其れから	それから	sorekara	and then; after that
各々	それぞれ	sorezore	each; every; either; respectively; severally
其れで	それで	sorede	and (conj); thereupon; because of that
其れでは	それでは	soredeha	in that situation; well then ...
其れでも	それでも	soredemo	but (still); and yet; nevertheless; even so; notwithstanding
其れ共	それとも	soretomo	or; or else
其れに	それに	soreni	besides; moreover
其れ程	それほど	sorehodo	to that degree; extent
其れ故	それゆえ	soreyue	therefore; for that reason; so
揃い	そろい	soroi	set; suit; uniform
徐々	そろそろ	sorosoro	gradually; steadily; quietly; slowly; soon
損失	そんしつ	sonshitsu	loss
存続	そんぞく	sonzoku	duration; continuance
沿い	ぞい	zoi	along
像	ぞう	zou	statue; image; figure; picture; portrait
増強	ぞうきょう	zoukyou	augment; reinforce; increase
蔵相	ぞうしょう	zoushou	Minister of Finance
増進	ぞうしん	zoushin	promoting; increase; advance
	ぞんざい	zonzai	rude; careless; slovenly
他意	たい	tai	ill will; malice; another intention; secret purpose; ulterior motive; fickleness; double-mindedness
対応	たいおう	taiou	interaction; correspondence; coping with; dealing with
退化	たいか	taika	degeneration; retrogression
体格	たいかく	taikaku	physique; constitution
大概	たいがい	taigai	in general; mainly
退学	たいがく	taigaku	dropping out of school
大金	たいきん	taikin	great cost
待遇	たいぐう	taiguu	treatment; reception
対決	たいけつ	taiketsu	confrontation; showdown
体験	たいけん	taiken	personal experience
対抗	たいこう	taikou	opposition; antagonism
対して	たいして	taishite	for; in regard to; per
大衆	たいしゅう	taishuu	general public
対処	たいしょ	taisho	deal with; cope
退職	たいしょく	taishoku	retirement (from office)
退治	たいじ	taiji	extermination
態勢	たいせい	taisei	attitude; conditions; preparations
対談	たいだん	taidan	talk; dialogue; conversation
対等	たいとう	taitou	equivalent
滞納	たいのう	tainou	non-payment; default
対比	たいひ	taihi	contrast; comparison
大部	たいぶ	taibu	most (e.g. most part); greater; fairly; a good deal; much
対辺	たいへん	taihen	(geometrical) opposite side
待望	たいぼう	taibou	expectant waiting
怠慢	たいまん	taiman	negligence; procrastination; carelessness
対面	たいめん	taimen	interview; meeting
対立	たいりつ	tairitsu	confrontation; opposition; antagonism
体力	たいりょく	tairyoku	physical strength
対話	たいわ	taiwa	interactive; interaction; conversation; dialogue
耐える	たえる	taeru	to bear; to endure
絶える	たえる	taeru	to die out; to peter out; to become extinct
堪える	たえる	taeru	to bear; to stand; to endure; to put up with; to support; to withstand; to resist; to brave; to be fit for; t
高	たか	taka	quantity; amount; volume; number; amount of money
高まる	たかまる	takamaru	to rise; to swell; to be promoted
焚火	たきび	takibi	(open) fire
沢山	たくさん	takusan	many; a lot; much
逞しい	たくましい	takumashii	burly; strong; sturdy
巧み	たくみ	takumi	skill; cleverness
類	たぐい	tagui	a kind
丈	たけ	take	height; stature; length; measure; all (one has)
足し算	たしざん	tashizan	addition
多数決	たすうけつ	tasuuketsu	majority rule
助け	たすけ	tasuke	assistance
携わる	たずさわる	tazusawaru	to participate; to take part
漂う	ただよう	tadayou	to drift about; to float; to hang in air
館	たち	tachi	1. mansion; small castle
立方	たちかた	tachikata	dancing (geisha)
忽ち	たちまち	tachimachi	at once; in a moment; suddenly; all at once
立ち寄る	たちよる	tachiyoru	to stop by; to drop in for a short visit
達者	たっしゃ	tassha	skillful; in good health
達成	たっせい	tassei	achievement
	たった	tatta	only; merely; but; no more than
尊い/貴い	たっとい	tattoi	precious; valuable; priceless; noble; exalted; sacred
尊ぶ	たっとぶ	tattobu	to value; to prize; to esteem
絶つ	たつ	tatsu	to sever; to cut off; to suppress; to abstain (from)
盾	たて	tate	shield; buckler; escutcheon; pretext
建前	たてまえ	tatemae	face; official stance; public position or attitude (as opposed to private thoughts)
奉る	たてまつる	tatematsuru	to offer; to present; to revere; to do respectfully
例え/仮令	たとえ	tatoe	example; even if; if; though; although
他動詞	たどうし	tadoushi	transitive verb (direct obj)
辿り着く	たどりつく	tadoritsuku	to grope along to; to struggle on to; to arrive somewhere after a struggle
辿る	たどる	tadoru	to follow (road); to pursue (course); to follow up
掌	たなごころ	tanagokoro	the palm
楽しむ	たのしむ	tanoshimu	to enjoy oneself
頼み	たのみ	tanomi	request; favor; reliance; dependence
煙草	たばこ	tabako	(pt:) (n) (uk) tobacco (pt: tabaco); cigarettes
度々	たびたび	tabitabi	often; repeatedly; frequently
他方	たほう	tahou	another side; different direction; (on) the other hand
多忙	たぼう	tabou	busy; pressure of work
給う	たまう	tamau	to receive; to grant
偶に	たまに	tamani	occasionally; once in a while
堪らない	たまらない	tamaranai	intolerable; unbearable; unendurable
溜まり	たまり	tamari	collected things; gathering place; arrears
賜る	たまわる	tamawaru	to grant; to bestow
例	ためし	tameshi	instance; example; case; precedent; experience; custom; usage; parallel; illustration
躊躇う	ためらう	tamerau	to hesitate
保つ	たもつ	tamotsu	to keep; to preserve; to hold; to retain; to maintain; to support; to sustain; to last; to endure; to keep we
容易い	たやすい	tayasui	easy; simple; light
多様	たよう	tayou	diversity; variety
弛み	たるみ	tarumi	slack; slackening; dullness; letdown
弛む	たるむ	tarumu	to slacken; to loosen; to relax
誰	たれ	tare	adjectival suffix for a person
垂れる	たれる	tareru	to hang; to droop; to drop; to lower; to pull down; to dangle; to sag; to drip; to ooze; to trickle; to leave
歎	たん	tan	grief; sigh; lamentation
反	たん	tan	roll of cloth (c. 10 yds.); .245 acres; 300 tsubo
単一	たんいつ	tanitsu	single; simple; sole; individual; unitory
短歌	たんか	tanka	tanka; 31-syllable Japanese poem
担架	たんか	tanka	stretcher; litter
短気	たんき	tanki	quick temper
探検	たんけん	tanken	exploration; expedition
短縮	たんしゅく	tanshuku	shortening; abbreviation; reduction
箪笥	たんす	tansu	chest of drawers
炭素	たんそ	tanso	carbon (C)
短大	たんだい	tandai	junior college
単調	たんちょう	tanchou	monotony; monotone; dullness
単独	たんどく	tandoku	sole; independence; single; solo (flight)
短波	たんぱ	tanpa	short wave
蛋白質	たんぱくしつ	tanpakushitsu	protein
第	だい	dai	ordinal
第一	だいいち	daiichi	first; foremost; # 1
大胆	だいたん	daitan	bold; daring; audacious
台無し	だいなし	dainashi	mess; spoiled; (come to) nothing
大便	だいべん	daiben	feces; excrement; shit
代弁	だいべん	daiben	pay by proxy; act for another; speak for another
台本	だいほん	daihon	libretto; scenario
代用	だいよう	daiyou	substitution
打開	だかい	dakai	break in the deadlock
妥協	だきょう	dakyou	compromise; giving in
丈	だけ	dake	only; just; as
妥結	だけつ	daketsu	agreement
打撃	だげき	dageki	1. blow; shock; strike; damage; 2. batting (baseball)
駄作	ださく	dasaku	poor work; rubbish
脱出	だっしゅつ	dasshutsu	escape
脱する	だっする	dassuru	to escape from; to get out
脱退	だったい	dattai	secession
	だぶだぶ	dabudabu	loose; baggy
騙す	だます	damasu	to trick; to cheat; to deceive
	だらけ	darake	implying (negatively) that something is full of e.g. mistakes
怠い	だるい	darui	sluggish; feel heavy; languid; dull
壇	だん	dan	1. platform; podium; rostrum; 2. (arch) mandala
団結	だんけつ	danketsu	unity; union; combination
断言	だんげん	dangen	declaration; affirmation
断然	だんぜん	danzen	firmly; absolutely; definitely
段々	だんだん	dandan	gradually; by degrees
旦那	だんな	danna	master (of house); husband (informal)
断面	だんめん	danmen	cross section
弾力	だんりょく	danryoku	elasticity; flexibility
治安	ちあん	chian	public order
近付く	ちかづく	chikazuku	to approach; to get near; to get acquainted with; to get closer
違える	ちがえる	chigaeru	to change
契る	ちぎる	chigiru	to pledge; to promise; to swear
畜産	ちくさん	chikusan	animal husbandry
畜生	ちくしょう	chikushou	beast; brute; damn
蓄積	ちくせき	chikuseki	accumulation; accumulate; store
知性	ちせい	chisei	intelligence
乳	ちち	chichi	milk; breast; loop
父母	ちちはは	chichihaha	father and mother; parents
縮まる	ちぢまる	chijimaru	to be shortened; to be contracted; to shrink
窒息	ちっそく	chissoku	suffocation
些とも	ちっとも	chittomo	not at all (neg. verb)
秩序	ちつじょ	chitsujo	order; regularity; system; method
知的	ちてき	chiteki	intellectual
著	ちゃく	chaku	counter for suits of clothing; arriving at ..
着手	ちゃくしゅ	chakushu	embarkation; launch
着色	ちゃくしょく	chakushoku	colouring; coloring
着席	ちゃくせき	chakuseki	sit down; seat
着目	ちゃくもく	chakumoku	attention
着陸	ちゃくりく	chakuriku	landing; alighting; touch down
着工	ちゃっこう	chakkou	start of (construction) work
茶の間	ちゃのま	chanoma	living room (Japanese style)
茶の湯	ちゃのゆ	chanoyu	tea ceremony
	ちやほや	chiyahoya	pamper; make a fuss of; spoil
昼間	ちゅうかん	chuukan	daytime; during the day
宙返り	ちゅうがえり	chuugaeri	somersault; looping-the-loop
中継	ちゅうけい	chuukei	relay; hook-up
忠告	ちゅうこく	chuukoku	advice; warning
中指	ちゅうし	chuushi	middle finger
中傷	ちゅうしょう	chuushou	slander; libel; defamation
忠実	ちゅうじつ	chuujitsu	fidelity; faithfulness
中枢	ちゅうすう	chuusuu	centre; pivot; mainstay; nucleus; backbone; central figure; pillar; key man
抽選	ちゅうせん	chuusen	lottery; raffle; drawing (of lots)
中断	ちゅうだん	chuudan	interruption; suspension; break
中腹	ちゅうっぱら	chuuppara	irritated; offended
中毒	ちゅうどく	chuudoku	poisoning
仲人	ちゅうにん	chuunin	go-between; matchmaker
昼飯	ちゅうはん	chuuhan	lunch; midday meal
中立	ちゅうりつ	chuuritsu	neutrality
中和	ちゅうわ	chuuwa	neutralize; counteract
腸	ちょう	chou	guts; bowels; intestines
蝶	ちょう	chou	butterfly
超	ちょう	chou	super-; ultra-; hyper-
庁	ちょう	chou	government office
調印	ちょういん	chouin	signature; sign; sealing
聴覚	ちょうかく	choukaku	the sense of hearing
長官	ちょうかん	choukan	chief; (government) secretary
聴講	ちょうこう	choukou	lecture attendance; auditing
徴収	ちょうしゅう	choushuu	collection; levy
聴診器	ちょうしんき	choushinki	stethoscope
挑戦	ちょうせん	chousen	challenge; defiance
長大	ちょうだい	choudai	very long; great length
調停	ちょうてい	choutei	arbitration; conciliation; mediation
恰度	ちょうど	choudo	just; right; exactly
長編	ちょうへん	chouhen	long (e.g. novel film)
丁目	ちょうめ	choume	district of a town; city block (of irregular size)
調理	ちょうり	chouri	cooking
調和	ちょうわ	chouwa	harmony
	ちょくちょく	chokuchoku	often; frequently; now and then; occasionally
直面	ちょくめん	chokumen	confrontation
著書	ちょしょ	chosho	literary work; book
貯蓄	ちょちく	chochiku	savings
直感	ちょっかん	chokkan	intuition
一寸	ちょっと	chotto	(ateji) (adv int) (uk) just a minute; a short time; a while; just a little; somewhat; easily; readily; rath
著名	ちょめい	chomei	well-known; noted; celebrated
	ちらっと	chiratto	at a glance; by accident
塵取り	ちりとり	chiritori	dustpan
治療	ちりょう	chiryou	medical treatment
賃金	ちんぎん	chingin	wages
沈殿	ちんでん	chinden	precipitation; settlement
沈没	ちんぼつ	chinbotsu	sinking; foundering
沈黙	ちんもく	chinmoku	silence; reticence
陳列	ちんれつ	chinretsu	exhibition; display; show
追及	ついきゅう	tsuikyuu	gaining on; carrying out; solving (crime)
追跡	ついせき	tsuiseki	pursuit
次いで	ついで	tsuide	next; secondly; subsequently
追放	ついほう	tsuihou	exile; banishment
費やす	ついやす	tsuiyasu	to spend; to devote; to waste
墜落	ついらく	tsuiraku	falling; crashing
通	つう	tsuu	connoisseur; counter for letters
痛感	つうかん	tsuukan	feeling keenly; fully realizing
通常	つうじょう	tsuujou	common; general; usually
痛切	つうせつ	tsuusetsu	keen; acute
杖	つえ	tsue	cane
遣い	つかい	tsukai	mission; simple task; doing
使い道	つかいみち	tsukaimichi	use
仕える	つかえる	tsukaeru	to serve; to work for
司る	つかさどる	tsukasadoru	to rule; to govern; to administer
束の間	つかのま	tsukanoma	moment; brief time; brief; transient
付き	つき	tsuki	attached to; impression; sociality; appearance; furnished with; under; to
付き合う	つきあう	tsukiau	to associate with; to keep company with; to get on with
月並み	つきなみ	tsukinami	every month; common
尽きる	つきる	tsukiru	to be used up; to be run out; to be exhausted; to be consumed; to come to an end
継ぎ目	つぎめ	tsugime	a joint; joining point
吐く	つく	tsuku	1. to breathe; 2. to tell (lies); 3. to vomit; to disgorge
尽くす	つくす	tsukusu	to exhaust; to run out; to serve (a person); to befriend
作り	つくり	tsukuri	make-up; sliced raw fish
造り	つくり	tsukuri	make up; structure; physique
造る	つくる	tsukuru	to make; to create; to manufacture; to draw up; to write; to compose; to build; to coin; to cultivate; to org
繕う	つくろう	tsukurou	to mend; to repair; to fix; to patch up; to darn; to tidy up; to adjust; to trim
接ぐ	つぐ	tsugu	to join; to piece together; to set (bones); to graft (trees)
継ぐ	つぐ	tsugu	to succeed
付け加える	つけくわえる	tsukekuwaeru	to add one thing to another
告げる	つげる	tsugeru	to inform
辻褄	つじつま	tsujitsuma	coherence; consistency
途中	つちゅう	tsuchuu	on the way; en route
突っ張る	つっぱる	tsupparu	to support; to become stiff; to become taut; to thrust (ones opponent); to stick to (ones opinion); to in
筒	つつ	tsutsu	pipe; tube
銃	つつ	tsutsu	gun
突く	つつく	tsutsuku	1. to thrust; to strike; to attack; 2. to poke; to nudge; to pick at
慎む	つつしむ	tsutsushimu	to be careful; to be chaste or discreet; to abstain or refrain
伝言	つてごと	tsutegoto	verbal message; rumor; word
勤まる	つとまる	tsutomaru	to be fit for; to be equal to; to function properly
勤め先	つとめさき	tsutomesaki	place of work
努めて	つとめて	tsutomete	make an effort!; work hard!
津波	つなみ	tsunami	tsunami; tidal wave
抓る	つねる	tsuneru	to pinch
募る	つのる	tsunoru	to invite; to solicit help participation etc
唾	つば	tsuba	saliva; sputum
呟く	つぶやく	tsubuyaku	to mutter; to murmur
瞑る	つぶる	tsuburu	to close the eyes
壷	つぼ	tsubo	tsubo jar; pot; vase
蕾	つぼみ	tsubomi	bud; flower bud
躓く	つまずく	tsumazuku	to stumble; to trip
摘む	つまむ	tsumamu	to pinch; to hold; to pick up
詰らない	つまらない	tsumaranai	insignificant; boring; trifling
詰まり	つまり	tsumari	in short; in brief; in other words; that is to say; in the long run; after all; blockade; stuffing; ultimate
積もり	つもり	tsumori	intention; plan
露	つゆ	tsuyu	dew
強まる	つよまる	tsuyomaru	to get strong; to gain strength
強める	つよめる	tsuyomeru	to strengthen; to emphasize
連なる	つらなる	tsuranaru	to extend; to stretch out; to stand in a row
貫く	つらぬく	tsuranuku	to go through
連ねる	つらねる	tsuraneru	to link; to join; to put together
釣り	つり	tsuri	fishing; angling
吊り革	つりかわ	tsurikawa	strap
釣鐘	つりがね	tsurigane	hanging bell
吊るす	つるす	tsurusu	to hang
手当て	てあて	teate	allowance; compensation; treatment; medical care
体	てい	tei	appearance; air; condition; state; form
提供	ていきょう	teikyou	offer; tender; program sponsoring; furnishing
定義	ていぎ	teigi	definition
提携	ていけい	teikei	cooperation; tie-up; joint business; link-up
体裁	ていさい	teisai	decency; style; form; appearance; show; get-up; format
梯子	ていし	teishi	ladder; stairs
定食	ていしょく	teishoku	set meal; special (of the day)
提示	ていじ	teiji	presentation; exhibit; suggest; citation
訂正	ていせい	teisei	correction; revision
停滞	ていたい	teitai	stagnation; tie-up; congestion; retention; accumulation; falling into arrears
邸宅	ていたく	teitaku	mansion; residence
定年	ていねん	teinen	retirement age
堤防	ていぼう	teibou	bank; weir
手遅れ	ておくれ	teokure	too late; belated treatment
手数	てかず	tekazu	number of moves; trouble
手掛かり	てがかり	tegakari	contact; trail; scent; on hand; hand hold; clue; key
手掛ける	てがける	tegakeru	to handle; to manage; to work with; to rear; to look after; to have experience with
手軽	てがる	tegaru	easy; simple; informal; offhand; cheap
的	てき	teki	-like; typical
適応	てきおう	tekiou	adaptation; accommodation; conformity
適宜	てきぎ	tekigi	suitability
適性	てきせい	tekisei	aptitude
手際	てぎわ	tegiwa	performance; skill; tact
手順	てじゅん	tejun	process; procedure; protocol
手錠	てじょう	tejou	handcuffs; manacles
手近	てぢか	tejika	near; handy; familiar
	てっきり	tekkiri	surely; certainly; beyond doubt
鉄鋼	てっこう	tekkou	iron and steel
徹する	てっする	tessuru	to sink in; to penetrate; to devote oneself; to believe in; to go through; to do intently and exclusively
鉄片	てっぺん	teppen	iron scraps
手配	てはい	tehai	arrangement; search (by police)
手筈	てはず	tehazu	arrangement; plan; programme
手引き	てびき	tebiki	guidance; guide; introduction
手本	てほん	tehon	model; pattern
手回し	てまわし	temawashi	preparations; arrangements
手元	てもと	temoto	on hand; at hand; at home
照り返す	てりかえす	terikaesu	to reflect; to throw back light
手分け	てわけ	tewake	division of labour
店	てん	ten	store; shop; establishment
点火	てんか	tenka	ignition; lighting; set fire to
転回	てんかい	tenkai	revolution; rotation
転換	てんかん	tenkan	convert; divert
転居	てんきょ	tenkyo	moving; changing residence
転勤	てんきん	tenkin	transfer; transmission
点検	てんけん	tenken	inspection; examination; checking
転校	てんこう	tenkou	change schools
天国	てんごく	tengoku	paradise; heaven; Kingdom of Heaven
天才	てんさい	tensai	genius; prodigy; natural gift
天災	てんさい	tensai	natural calamity; disaster
展示	てんじ	tenji	exhibition; display
天井	てんじょう	tenjou	ceiling; ceiling price
転じる	てんじる	tenjiru	to turn; to shift; to alter; to distract
点線	てんせん	tensen	dotted line; perforated line
天体	てんたい	tentai	heavenly body
転転	てんてん	tenten	rolling about; moving from place to place; being passed around repeatedly
	てんで	tende	(not) at all; altogether; entirely
転任	てんにん	tennin	change of post
展望	てんぼう	tenbou	view; outlook; prospect
転落	てんらく	tenraku	fall; degradation; slump
出合う/出くわす	であう/でくわす	deau/ dekuwasu	to meet by chance; to come across; to happen to encounter; to hold a rendezvous; to have a date
出入り口	でいりぐち	deiriguchi	exit and entrance
	でかい	dekai	huge
出来物	できもの	dekimono	able man; tumour; growth; boil; ulcer; abcess; rash; pimple
出切る	できる	dekiru	to be out of; to have no more at hand
出鱈目	でたらめ	detarame	irresponsible utterance; nonsense; nonsensical; random; haphazard; unsystematic
出直し	でなおし	denaoshi	adjustment; touch up
田園	でんえん	denen	country; rural districts
電源	でんげん	dengen	source of electricity; power (button on TV etc.)
伝説	でんせつ	densetsu	tradition; legend; folklore
電線	でんせん	densen	electric line
伝達	でんたつ	dentatsu	transmission (e.g. news); communication; delivery
伝来	でんらい	denrai	ancestral; hereditary; imported; transmitted; handed down
	と	to	1. if (conjunction); 2. promoted pawn (shogi) (abbr)
問い合わせる	といあわせる	toiawaseru	to enquire; to seek information
問屋	といや	toiya	wholesale store
問う	とう	tou	to ask; to question; to charge (i.e. with a crime); to accuse; without regard to (neg)
棟	とう	tou	place; section; building
等	とう	tou	et cetera; etc.; and the like
陶器	とうき	touki	pottery; ceramics
等級	とうきゅう	toukyuu	grade; class
討議	とうぎ	tougi	debate; discussion
登校	とうこう	toukou	attendance (at school)
統合	とうごう	tougou	integration; unification; synthesis
倒産	とうさん	tousan	(corporate) bankruptcy; insolvency
投資	とうし	toushi	investment
統治	とうじ	touji	rule; reign; government; governing
統制	とうせい	tousei	regulation; control
当選	とうせん	tousen	being elected; winning the prize
逃走	とうそう	tousou	flight; desertion; escape
統率	とうそつ	tousotsu	command; lead; generalship; leadership
到達	とうたつ	toutatsu	reaching; attaining; arrival
到底	とうてい	toutei	(cannot) possibly
丁々	とうとう	toutou	clashing of swords; felling of trees; ringing of an ax
投入	とうにゅう	tounyuu	throw; investment; making (an electrical circuit)
当人	とうにん	tounin	the one concerned; the said person
逃亡	とうぼう	toubou	escape
冬眠	とうみん	toumin	hibernation; winter sleep
登録	とうろく	touroku	registration; register; entry; record
討論	とうろん	touron	debate; discussion
遠ざかる	とおざかる	toozakaru	to go far off
遠回り	とおまわり	toomawari	detour; roundabout way
通りかかる	とおりかかる	toorikakaru	to happen to pass by
兎角	とかく	tokaku	anyhow; anyway; somehow or other; generally speaking; in any case; this and that; many; be apt to
咎める	とがめる	togameru	to blame; to find fault; to take someone to task; to aggravate (an injury)
時折	ときおり	tokiori	sometimes
跡切れる	とぎれる	togireru	to pause; to be interrupted
説く	とく	toku	to explain; to advocate; to preach; to persuade
特技	とくぎ	tokugi	special skill
特産	とくさん	tokusan	specialty; special product
特集	とくしゅう	tokushuu	feature (e.g. newspaper); special edition; report
得点	とくてん	tokuten	score; points made; marks obtained; runs
特派	とくは	tokuha	send specially; special envoy
特有	とくゆう	tokuyuu	characteristic (of); peculiar (to)
研ぐ	とぐ	togu	to sharpen; to grind; to scour; to hone; to polish; to wash (rice)
刺	とげ	toge	thorn; splinter; spine; biting words
遂げる	とげる	togeru	to accomplish; to achieve; to carry out
床	とこ	toko	bed; sickbed; alcove; padding
所が	ところが	tokoroga	however; while; even if
所で	ところで	tokorode	by the way; even if; no matter what
年頃	としごろ	toshigoro	age; marriageable age; age of puberty; adolescence; for some years
年寄り	としより	toshiyori	old people; the aged
戸締り	とじまり	tojimari	closing up; fastening the doors
途上	とじょう	tojou	en route; half way
綴じる	とじる	tojiru	to bind; to file
途絶える	とだえる	todaeru	to stop; to cease; to come to an end
特許	とっきょ	tokkyo	special permission; patent
疾っくに	とっくに	tokkuni	long ago; already; a long time ago
特権	とっけん	tokken	privilege; special right
咄嗟	とっさ	tossa	moment; instant
取っ手	とって	totte	handle; grip; knob
突破	とっぱ	toppa	breaking through; breakthrough; penetration
突如	とつじょ	totsujo	suddenly; all of a sudden
迚も	とても	totemo	very; awfully; exceedingly
整える	ととのえる	totonoeru	to put in order; to get ready; to arrange; to adjust
届け	とどけ	todoke	report; notification; registration
滞る	とどこおる	todokooru	to stagnate; to be delayed
止まる	とどまる	todomaru	to be limited to
留める/止める	とどめる	todomeru	to stop; to cease; to put an end to
唱える	となえる	tonaeru	to recite; to chant; to call upon
兎に角	とにかく	tonikaku	anyhow; at any rate; anyway; somehow or other; generally speaking; in any case
殿様	とのさま	tonosama	feudal lord
幕	とばり	tobari	curtain; bunting; act (in play)
帳	とばり	tobari	curtain
扉	とびら	tobira	door; opening
徒歩	とほ	toho	walking; going on foot
乏しい	とぼしい	toboshii	meagre; scarce; limited; destitute; hard up; scanty; poor
富	とみ	tomi	wealth; fortune
富む	とむ	tomu	to be rich; to become rich
兎も角	ともかく	tomokaku	anyhow; anyway; somehow or other; generally speaking; in any case
共稼ぎ	ともかせぎ	tomokasegi	working together; (husband and wife) earning a living together
灯	ともしび	tomoshibi	light
伴う	ともなう	tomonau	to accompany; to bring with; to be accompanied by; to be involved in
共働き	ともばたらき	tomobataraki	dual income
捕らえる	とらえる	toraeru	to seize; to grasp; to capture; to arrest
取りあえず	とりあえず	toriaezu	at once; first of all; for the time being
取り扱い	とりあつかい	toriatsukai	treatment; service; handling; management
取り扱う	とりあつかう	toriatsukau	to treat; to handle; to deal in
鳥居	とりい	torii	torii (Shinto shrine archway)
取り替え	とりかえ	torikae	swap; exchange
取り組む	とりくむ	torikumu	to tackle; to wrestle with; to engage in a bout; to come to grips with
取り締まり	とりしまり	torishimari	control; management; supervision
取り締まる	とりしまる	torishimaru	to manage; to control; to supervise
取り調べる	とりしらべる	torishiraberu	to investigate; to examine
取り立てる	とりたてる	toritateru	to collect; to extort; to appoint; to promote
取り次ぐ	とりつぐ	toritsugu	to act as an agent for; to announce (someone); to convey (a message)
取り除く	とりのぞく	torinozoku	to remove; to take away; to set apart
取り引き	とりひき	torihiki	transactions; dealings; business
取り巻く	とりまく	torimaku	to surround; to circle; to enclose
取り混ぜる	とりまぜる	torimazeru	to mix; to put together
取り戻す	とりもどす	torimodosu	to take back; to regain
取り寄せる	とりよせる	toriyoseru	to order; to send away for
取り分	とりわけ	toriwake	especially; above all
蕩ける	とろける	torokeru	to be enchanted with
	とんだ	tonda	terrible; awful; serious; preposterous; absolutely not
胴	どう	dou	trunk; body; frame
働	どう	dou	work; labor
同	どう	dou	the same; the said; ibid.
同意	どうい	doui	agreement; consent; same meaning; same opinion; approval
動員	どういん	douin	mobilization
同感	どうかん	doukan	agreement; same opinion; same feeling; sympathy; concurrence
動機	どうき	douki	motive; incentive
同級	どうきゅう	doukyuu	the same grade; same class
同居	どうきょ	doukyo	living together
動向	どうこう	doukou	trend; tendency; movement; attitude
同士	どうし	doushi	fellow; companion; comrade
同志	どうし	doushi	same mind; comrade; kindred soul
如何して	どうして	doushite	why?; for what reason; how; in what way; for what purpose; what for
如何しても	どうしても	doushitemo	by all means; at any cost; no matter what; after all; in the long run; cravingly; at any rate; surely
同情	どうじょう	doujou	sympathy; compassion; sympathize; pity; feel for
道場	どうじょう	doujou	dojo; hall used for martial arts training; mandala
何卒	どうぞ	douzo	please; kindly; by all means
どうぞ宜しく	どうぞよろしく	douzoyoroshiku	pleased to meet you
同調	どうちょう	douchou	sympathy; agree with; alignment; tuning
動的	どうてき	douteki	dynamic; kinetic
同等	どうとう	doutou	equality; equal; same rights; same rank
堂々	どうどう	doudou	magnificent; grand; impressive
	どうにか	dounika	in some way or other; one way or another
導入	どうにゅう	dounyuu	introduction; bringing in; leading in
同封	どうふう	doufuu	enclosure (e.g. in a letter)
同盟	どうめい	doumei	alliance; union; league
	どうやら	douyara	it seems like; somehow or other
動揺	どうよう	douyou	disturbance; unrest; shaking; trembling; pitching; rolling; oscillation; agitation; excitement; commotion
動力	どうりょく	douryoku	power; motive power; dynamic force
独裁	どくさい	dokusai	dictatorship; despotism
読者	どくしゃ	dokusha	reader
独自	どくじ	dokuji	original; peculiar; characteristic
独占	どくせん	dokusen	monopoly
独創	どくそう	dokusou	originality
何処	どこ	doko	where; what place
何処か	どこか	dokoka	somewhere; anywhere; in some respects
土産	どさん	dosan	product of the land
土台	どだい	dodai	foundation; base; basis
何方	どちら	dochira	which; who
土手	どて	dote	embankment; bank
何方	どなた	donata	who?
怒鳴る	どなる	donaru	to shout; to yell
何の	どの	dono	which; what
土俵	どひょう	dohyou	arena
土木	どぼく	doboku	public works
何れ	どれ	dore	well; now; let me see; which (of three or more)
何々	どれどれ	doredore	which (emphatic)
度忘れ	どわすれ	dowasure	lapse of memory; forget for a moment
鈍感	どんかん	donkan	thickheadedness; stolidity
内閣	ないかく	naikaku	cabinet; (government) ministry
乃至	ないし	naishi	from...to; between...and; or
内臓	ないぞう	naizou	internal organs; intestines; viscera
内部	ないぶ	naibu	interior; inside; internal
内乱	ないらん	nairan	civil war; insurrection; rebellion; domestic conflict
内陸	ないりく	nairiku	inland
苗	なえ	nae	rice seedling
尚	なお	nao	furthermore; still; yet; more; still more; greater; further; less
尚更	なおさら	naosara	all the more; still less
中程	なかほど	nakahodo	middle; midway
流し	ながし	nagashi	sink
長々	ながなが	naganaga	long; drawn-out; very long
殴る	なぐる	naguru	to strike; to hit
嘆く	なげく	nageku	to sigh; to lament; to grieve
投げ出す	なげだす	nagedasu	to throw down; to abandon; to sacrifice; to throw out
和やか	なごやか	nagoyaka	mild; calm; gentle; quiet; harmonious
名残	なごり	nagori	remains; traces; memory
情け	なさけ	nasake	sympathy; compassion
情け深い	なさけぶかい	nasakebukai	tender-hearted; compassionate
為さる	なさる	nasaru	to do
詰る	なじる	najiru	to rebuke; to scold; to tell off
何故	なぜ	naze	why; how
何故なら	なぜなら	nazenara	because
名高い	なだかい	nadakai	famous; celebrated; well-known
雪崩	なだれ	nadare	avalanche
懐く	なつく	natsuku	to become emotionally attached
名付ける	なづける	nazukeru	to name (someone)
何気ない	なにげない	nanigenai	casual; unconcerned
何しろ	なにしろ	nanishiro	at any rate; anyhow; anyway; in any case
何卒	なにとぞ	nanitozo	please
何も	なにも	nanimo	nothing
何より	なにより	naniyori	most; best
七日	なぬか	nanuka	seven days; the seventh day (of the month)
名札	なふだ	nafuda	name plate; name tag
生臭い	なまぐさい	namagusai	smelling of fish or blood; fish or meat
生温い	なまぬるい	namanurui	lukewarm; halfhearted
生身	なまみ	namami	living flesh; flesh and blood; the quick
鉛	なまり	namari	lead (the metal)
鈍る	なまる	namaru	to become less capable; to grow dull; to become blunt; to weaken
並み	なみ	nami	average; medium; common; ordinary
滑らか	なめらか	nameraka	smoothness; glassiness
嘗める	なめる	nameru	to lick; to taste; to experience; to make fun of; to make light of; to put down; to treat with contempt
悩ましい	なやましい	nayamashii	seductive; melancholy; languid
悩ます	なやます	nayamasu	to afflict; to torment; to harass; to molest
悩み	なやみ	nayami	trouble(s); worry; distress; anguish; agony; problem
平均	ならし	narashi	equilibrium; balance; average; mean
慣らす	ならす	narasu	to accustom
馴らす	ならす	narasu	to domesticate; to tame
並びに	ならびに	narabini	and
成り立つ	なりたつ	naritatsu	to conclude; to consist of; to be practical (logical feasible viable); to hold true
成る丈	なるたけ	narutake	as much as possible; if possible
成るべく	なるべく	narubeku	as much as possible
慣れ	なれ	nare	practice; experience
馴れ馴れしい	なれなれしい	narenareshii	over-familiar
難	なん	nan	difficulty; hardships; defect
南	なん	nan	south
	なんか	nanka	things like ...; or something like that .. (often derogatory)
何だか	なんだか	nandaka	a little; somewhat; somehow
	なんだかんだ	nandakanda	something or other
何て	なんて	nante	how...!; what...!
何と	なんと	nanto	what; how; whatever
何となく	なんとなく	nantonaku	somehow or other; for some reason or another
何とも	なんとも	nantomo	nothing (with neg. verb); quite; not a bit
何なり	なんなり	nannari	any; anything; whatever
荷	に	ni	load; baggage; cargo
似通う	にかよう	nikayou	to resemble closely
面皰	にきび	nikibi	pimple; acne
賑わう	にぎわう	nigiwau	to prosper; to flourish; to do thriving business; to be crowded with people
悪い	にくい	nikui	hateful; abominable; poor-looking
憎しみ	にくしみ	nikushimi	hatred
肉親	にくしん	nikushin	blood relationship; blood relative
肉体	にくたい	nikutai	the body; the flesh
逃げ出す	にげだす	nigedasu	to run away; to escape from
西日	にしび	nishibi	westering sun
滲む	にじむ	nijimu	to run; to blur; to spread; to blot; to ooze
日夜	にちや	nichiya	day and night; always
日当	にっとう	nittou	daily allowance
荷造り	にづくり	nizukuri	packing; baling; crating
担う	になう	ninau	to carry on shoulder; to bear (burden); to shoulder (gun)
二人	ににん	ninin	two persons; two people; pair; couple
にも拘らず	にもかかわらず	nimokakawarazu	in spite of; nevertheless
入手	にゅうしゅ	nyuushu	obtaining; coming to hand
入賞	にゅうしょう	nyuushou	winning a prize or place (in a contest)
入浴	にゅうよく	nyuuyoku	bathe; bathing
尿	にょう	nyou	urine
俄か	にわか	niwaka	sudden; abrupt; unexpected; improvised; offhand
認識	にんしき	ninshiki	recognition; cognizance
妊娠	にんしん	ninshin	conception; pregnancy
人情	にんじょう	ninjou	humanity; empathy; kindness; sympathy; human nature; common sense; customs and manners
任務	にんむ	ninmu	duty; function; office; mission; task
任命	にんめい	ninmei	appointment; nomination; ordination; commission; designation
抜かす	ぬかす	nukasu	to omit; to leave out
抜け出す	ぬけだす	nukedasu	to slip out; to sneak away; to excel
盗み	ぬすみ	nusumi	stealing
沼	ぬま	numa	swamp; bog; pond; lake
音	ね	ne	sound; note
値打ち	ねうち	neuchi	value; worth; price; dignity
寝かせる	ねかせる	nekaseru	to put to bed; to lay down; to ferment
捻子	ねじ	neji	screw; helix; spiral
ねじ回し	ねじまわし	nejimawashi	screwdriver
捻じれる	ねじれる	nejireru	to twist; to wrench; to screw
鼠	ねず	nezu	1. mouse; rat; 2. dark gray; slate color
妬む	ねたむ	netamu	to be jealous; to be envious
強請る	ねだる	nedaru	to tease; to coax; to solicit; to demand
熱湯	ねっとう	nettou	boiling water
熱意	ねつい	netsui	zeal; enthusiasm
熱量	ねつりょう	netsuryou	temperature
粘り	ねばり	nebari	stickyness; viscosity
粘る	ねばる	nebaru	to be sticky; to be adhesive; to persevere; to persist; to stick to
値引き	ねびき	nebiki	price reduction; discount
根回し	ねまわし	nemawashi	making necessary arrangements
眠たい	ねむたい	nemutai	sleepy
練る	ねる	neru	to knead; to work over; to polish up
念	ねん	nen	sense; idea; thought; feeling; desire; concern; attention; care
年鑑	ねんかん	nenkan	yearbook
年号	ねんごう	nengou	name of an era; year number
燃焼	ねんしょう	nenshou	burning; combustion
年生	ねんせい	nensei	pupil in .... year; student in .... year
年長	ねんちょう	nenchou	seniority
燃料	ねんりょう	nenryou	fuel
年輪	ねんりん	nenrin	annual tree ring
脳	のう	nou	brain; memory
農耕	のうこう	noukou	farming; agriculture
農場	のうじょう	noujou	farm (agriculture)
農地	のうち	nouchi	agricultural land
納入	のうにゅう	nounyuu	payment; supply
逃す	のがす	nogasu	to let loose; to set free; to let escape
逃れる	のがれる	nogareru	to escape
軒並み	のきなみ	nokinami	row of houses
鋸	のこぎり	nokogiri	saw
望ましい	のぞましい	nozomashii	desirable; hoped for
臨む	のぞむ	nozomu	to look out on; to face; to deal with; to attend (function)
乗っ取る	のっとる	nottoru	to capture; to occupy; to usurp
長閑	のどか	nodoka	tranquil; calm; quiet
罵る	ののしる	nonoshiru	to speak ill of; to abuse
延べ	のべ	nobe	futures; credit (buying); stretching; total
飲み込む	のみこむ	nomikomu	to gulp down; to swallow deeply; to understand; to take in; to catch on to; to learn; to digest
乗り換え	のりかえ	norikae	transfer (trains buses etc.)
乗り込む	のりこむ	norikomu	to board; to embark on; to get into (a car); to ship (passengers); to man (a ship); to help (someone) int
刃	は	ha	edge (of a sword)
派	は	ha	clique; faction; school
把握	はあく	haaku	grasp; catch; understanding
肺	はい	hai	lung
廃棄	はいき	haiki	annullment; disposal; abandon; scrap; discarding; repeal
配給	はいきゅう	haikyuu	distribution (eg. films rice)
配偶者	はいぐうしゃ	haiguusha	spouse; wife; husband
拝啓	はいけい	haikei	Dear (so and so)
背景	はいけい	haikei	background; scenery; setting; circumstance
背後	はいご	haigo	back; rear
灰皿	はいさら	haisara	ashtray
廃止	はいし	haishi	abolition; repeal
拝借	はいしゃく	haishaku	borrowing
排除	はいじょ	haijo	exclusion; removal; rejection
排水	はいすい	haisui	drainage
敗戦	はいせん	haisen	defeat; losing a war
配置	はいち	haichi	arrangement (of resources); disposition
配布	はいふ	haifu	distribution
配分	はいぶん	haibun	distribution; allotment
配慮	はいりょ	hairyo	consideration; concern; forethought
配列	はいれつ	hairetsu	arrangement; array (programming)
映える	はえる	haeru	to shine; to look attractive; to look pretty
破壊	はかい	hakai	destruction
墓地	はかち	hakachi	cemetery; graveyard
捗る	はかどる	hakadoru	to make progress; to move right ahead (with the work); to advance
果ない	はかない	hakanai	fleeting; transient; short-lived; momentary; vain; fickle; miserable; empty; ephemeral
諮る	はかる	hakaru	to consult with; to confer
図る	はかる	hakaru	to plot; to attempt; to plan; to take in; to deceive; to devise; to design; to refer A to B
破棄	はき	haki	revocation; annulment; breaking (e.g. treaty)
泊	はく	haku	counter for nights of a stay
迫害	はくがい	hakugai	persecution
薄弱	はくじゃく	hakujaku	feebleness; weakness; weak
白状	はくじょう	hakujou	confession
剥がす/剥ぐ	はがす/はぐ	hagasu/ hagu	to tear off; to peel off; to rip off; to strip off; to skin; to flay; to disrobe; to deprive of
派遣	はけん	haken	dispatch; send
励ます	はげます	hagemasu	to encourage; to cheer; to raise (the voice)
励む	はげむ	hagemu	to be zealous; to brace oneself; to endeavour; to strive; to make an effort
剥げる	はげる	hageru	to come off; to be worn off; to fade; to discolor
鋏	はさみ	hasami	scissors
柱	はしら	hashira	pillar; post
橋渡し	はしわたし	hashiwatashi	bridge building; mediation
恥	はじ	haji	shame; embarrassment
弾く	はじく	hajiku	to flip; to snap
始め	はじめ	hajime	beginning; start; origin
始めまして	はじめまして	hajimemashite	How do you do?; I am glad to meet you
恥じらう	はじらう	hajirau	to feel shy; to be bashful; to blush
恥じる	はじる	hajiru	to feel ashamed
蓮	はす	hasu	lotus
筈	はず	hazu	it should be so
弾む	はずむ	hazumu	to spring; to bound; to bounce; to be stimulated; to be encouraged; to get lively; to treat oneself to; to
破損	はそん	hason	damage
機	はた	hata	loom
果たして	はたして	hatashite	as was expected; really
果たす	はたす	hatasu	to accomplish; to fulfill; to carry out; to achieve
裸足	はだし	hadashi	barefoot
蜂蜜	はちみつ	hachimitsu	honey
発掘	はっくつ	hakkutsu	excavation; exhumation
発生	はっせい	hassei	outbreak; spring forth; occurrence; incidence; origin
発足	はっそく	hassoku	starting; inauguration
初	はつ	hatsu	first; new
発	はつ	hatsu	departure; beginning; counter for gunshots
発育	はついく	hatsuiku	(physical) growth; development
発芽	はつが	hatsuga	burgeoning
発言	はつげん	hatsugen	utterance; speech; proposal
発病	はつびょう	hatsubyou	attack (disease)
初耳	はつみみ	hatsumimi	something heard for the first time
果て	はて	hate	the end; the extremity; the limit(s); the result
果てる	はてる	hateru	to end; to be finished; to be exhausted; to die; to perish
話し合い	はなしあい	hanashiai	discussion; conference
甚だ	はなはだ	hanahada	very; greatly; exceedingly
華々しい	はなばなしい	hanabanashii	brilliant; magnificent; spectacular
花びら	はなびら	hanabira	(flower) petal
華やか	はなやか	hanayaka	gay; showy; brilliant; gorgeous; florid
阻む	はばむ	habamu	to keep someone from doing; to stop; to prevent; to check; to hinder; to obstruct; to oppose; to thwart
浜	はま	hama	beach; seashore
浜辺	はまべ	hamabe	beach; foreshore
填まる	はまる	hamaru	to get into; to go into; to fit; to be fit for; to suit; to fall into; to plunge into; to be deceived; to be
歯磨	はみがき	hamigaki	dentifrice; toothpaste
填める	はめる	hameru	to get in; to insert; to put on; to make love
生やす	はやす	hayasu	to grow; to cultivate; to wear beard
早める	はやめる	hayameru	to hasten; to quicken; to expedite; to precipitate; to accelerate
流行	はやり	hayari	fashionable; fad; in vogue; prevailing
腹立ち	はらだち	haradachi	anger
原っぱ	はらっぱ	harappa	open field; empty lot; plain
張り紙	はりがみ	harigami	paper patch; paper backing; poster
遥か	はるか	haruka	far; far-away; distant; remote; far off
破裂	はれつ	haretsu	explosion; rupture; break off
腫れる	はれる	hareru	to swell (from inflammation); to become swollen
班	はん	han	group; party; section (mil)
判	はん	han	seal; stamp; monogram signature; judgment
版	はん	han	edition
繁栄	はんえい	hanei	prospering; prosperity; thriving; flourishing
反感	はんかん	hankan	antipathy; revolt; animosity
版画	はんが	hanga	art print
反響	はんきょう	hankyou	echo; reverberation; repercussion; reaction; influence
判決	はんけつ	hanketsu	judicial decision; judgement; sentence; decree
反撃	はんげき	hangeki	counterattack; counteroffensive; counterblow
反射	はんしゃ	hansha	reflection; reverberation
繁殖	はんしょく	hanshoku	breed; multiply; increase; propagation
繁盛	はんじょう	hanjou	prosperity; flourishing; thriving
反する	はんする	hansuru	to be inconsistent with; to oppose; to contradict; to transgress; to rebel
判定	はんてい	hantei	judgement; decision; award; verdict
反応	はんのう	hannou	reaction; response
半端	はんぱ	hanpa	remnant; fragment; incomplete set; fraction; odd sum; incompleteness
反発	はんぱつ	hanpatsu	repelling; rebound; recover; oppose
反乱	はんらん	hanran	insurrection; mutiny; rebellion; revolt; uprising
氾濫	はんらん	hanran	overflowing; flood
黴菌	ばいきん	baikin	bacteria; germ(s)
賠償	ばいしょう	baishou	reparations; indemnity; compensation
倍率	ばいりつ	bairitsu	diameter; magnification
馬鹿馬鹿しい	ばかばかしい	bakabakashii	stupid
馬鹿らしい	ばからしい	bakarashii	absurd
漠然	ばくぜん	bakuzen	obscure; vague; equivocal
爆弾	ばくだん	bakudan	bomb
爆破	ばくは	bakuha	blast; explosion; blow up
暴露	ばくろ	bakuro	disclosure; exposure; revelation
化ける	ばける	bakeru	to appear in disguise; to take the form of; to change for the worse
罰	ばち	bachi	(divine) punishment; curse; retribution
	ばてる	bateru	to be exhausted; to be worn out
発条	ばね	bane	spring (e.g. coil leaf)
散蒔く	ばらまく	baramaku	to disseminate; to scatter; to give money freely
判	ばん	ban	size (of paper or books)
万	ばん	ban	many; all
万人	ばんじん	banjin	all people; everybody; 10000 people
万能	ばんのう	bannou	all-purpose; almighty; omnipotent
番目	ばんめ	banme	cardinal number suffix
非	ひ	hi	faulty-; non-
費	ひ	hi	cost; expense
延いては	ひいては	hiiteha	not only...but also; in addition to; consequently
控室	ひかえしつ	hikaeshitsu	waiting room
控える	ひかえる	hikaeru	to draw in; to hold back; to make notes; to be temperate in
悲観	ひかん	hikan	pessimism; disappointment
匹	ひき	hiki	head; small animal counter; roll of cloth
引き上げる	ひきあげる	hikiageru	to withdraw; to leave; to pull out; to retire
率いる	ひきいる	hikiiru	to lead; to spearhead (a group); to command (troops)
引き受ける	ひきうける	hikiukeru	to undertake; to take up; to take over; to be responsible for; to guarantee; to contract (disease)
引き起こす	ひきおこす	hikiokosu	to cause
引き下げる	ひきさげる	hikisageru	to pull down; to lower; to reduce; to withdraw
引きずる	ひきずる	hikizuru	to seduce; to drag along; to pull; to prolong; to support
引き取る	ひきとる	hikitoru	to take charge of; to take over; to retire to a private place
引き分け	ひきわけ	hikiwake	a draw (in competition); tie game
否決	ひけつ	hiketsu	rejection; negation; voting down
非行	ひこう	hikou	delinquency; misconduct
日頃	ひごろ	higoro	normally; habitually
久しい	ひさしい	hisashii	long; long-continued; old (story)
久し振り	ひさしぶり	hisashiburi	after a long time
悲惨	ひさん	hisan	misery
秘書	ひしょ	hisho	(private) secretary
比重	ひじゅう	hijuu	specific gravity
密か	ひそか	hisoka	secret; private; surreptitious
浸す	ひたす	hitasu	to soak; to dip; to drench
一向	ひたすら	hitasura	earnestly
左利き	ひだりきき	hidarikiki	left-handedness; sake drinker; left-hander
引っ掻く	ひっかく	hikkaku	to scratch
引っ掛ける	ひっかける	hikkakeru	1. to hang (something) on (something); to throw on (clothes); 2. to hook; to catch; to trap; to ensnar
必修	ひっしゅう	hisshuu	required (subject)
匹敵	ひってき	hitteki	comparing with; match; rival; equal
未	ひつじ	hitsuji	eighth sign of Chinese zodiac (The Ram 1pm-3pm south-southwest June)
必然	ひつぜん	hitsuzen	inevitable; necessary
一息	ひといき	hitoiki	puffy; a breath; a pause; an effort
単	ひとえ	hitoe	one layer; single
人柄	ひとがら	hitogara	personality; character; personal appearance; gentility
一頃	ひところ	hitokoro	once; some time ago
人質	ひとじち	hitojichi	hostage; prisoner
一筋	ひとすき	hitosuki	a line; earnestly; blindly; straightforwardly
一まず	ひとまず	hitomazu	for the present; once; in outline
一人でに	ひとりでに	hitorideni	by itself; automatically; naturally
酷い	ひどい	hidoi	cruel; awful; severe; very bad; serious; terrible; heavy; violent
日取り	ひどり	hidori	fixed date; appointed day
雛	ひな	hina	young bird; chick; doll
日向	ひなた	hinata	sunny place; in the sun
非難	ひなん	hinan	blame; attack; criticism
避難	ひなん	hinan	taking refuge; finding shelter
日の丸	ひのまる	hinomaru	the Japanese flag
火花	ひばな	hibana	spark
日々	ひび	hibi	every day; daily; day after day
悲鳴	ひめい	himei	shriek; scream
百科事典	ひゃっかじてん	hyakkajiten	encyclopedia
百科辞典	ひゃっかじてん	hyakkajiten	encyclopedia
冷やかす	ひやかす	hiyakasu	to banter; to make fun of; to jeer at; to cool; to refrigerate
日焼け	ひやけ	hiyake	sunburn
票	ひょう	hyou	label; ballot; ticket; sign
標語	ひょうご	hyougo	motto; slogan; catchword
	ひょっと	hyotto	possibly; accidentally
平たい	ひらたい	hiratai	flat; even; level; simple; plain
比率	ひりつ	hiritsu	ratio; proportion; percentage
肥料	ひりょう	hiryou	manure; fertilizer
比例	ひれい	hirei	proportion
疲労	ひろう	hirou	fatigue; weariness
広まる	ひろまる	hiromaru	to spread; to be propagated
貧困	ひんこん	hinkon	poverty; lack
品質	ひんしつ	hinshitsu	quality
品種	ひんしゅ	hinshu	brand; kind; description
貧弱	ひんじゃく	hinjaku	poor; meagre; insubstantial
頻繁	ひんぱん	hinpan	frequency
美	び	bi	beauty
微笑	びしょう	bishou	smile
美術	びじゅつ	bijutsu	art; fine arts
吃驚	びっくり	bikkuri	be surprised; be amazed; be frightened; astonishment
	びっしょり	bisshori	wet through; drenched
描写	びょうしゃ	byousha	depiction; description; portrayal
	びり	biri	last on the list; at the bottom
微量	びりょう	biryou	minuscule amount; extremely small quantity
敏感	びんかん	binkan	sensibility; susceptibility; sensitive (to); well attuned to
貧乏	びんぼう	binbou	poverty; destitute; poor
歩	ふ	fu	pawn (in chess or shogi)
不意	ふい	fui	sudden; abrupt; unexpected; unforeseen
封	ふう	fuu	seal
封鎖	ふうさ	fuusa	blockade; freezing (funds)
風習	ふうしゅう	fuushuu	custom
風俗	ふうぞく	fuuzoku	1. manners; customs; 2. sex service; sex industry
風土	ふうど	fuudo	natural features; topography; climate; spiritual features
不可欠	ふかけつ	fukaketsu	indispensable; essential
深める	ふかめる	fukameru	to deepen; to heighten; to intensify
不吉	ふきつ	fukitsu	ominous; sinister; bad luck; ill omen; inauspiciousness
不況	ふきょう	fukyou	recession; depression; slump
布巾	ふきん	fukin	tea-towel; dish cloth
福	ふく	fuku	good fortune
復旧	ふくきゅう	fukukyuu	restoration; restitution; rehabilitation
複合	ふくごう	fukugou	composite; complex
福祉	ふくし	fukushi	welfare; well-being
覆面	ふくめん	fukumen	mask; veil; disguise
膨れる	ふくれる	fukureru	to get cross; to get sulky; to swell (out); to expand; to be inflated; to distend; to bulge
不景気	ふけいき	fukeiki	business recession; hard times; depression; gloom; sullenness; cheerlessness
老ける	ふける	fukeru	to age
布告	ふこく	fukoku	edict; ordinance; proclamation
富豪	ふごう	fugou	wealthy person; millionaire
負債	ふさい	fusai	debt; liabilities
相応しい	ふさわしい	fusawashii	appropriate
不在	ふざい	fuzai	absence
不山戯る	ふざける	fuzakeru	to romp; to gambol; to frolic; to joke; to make fun of; to flirt
負傷	ふしょう	fushou	injury; wound
不審	ふしん	fushin	incomplete understanding; doubt; question; distrust; suspicion; strangeness; infidelity
不振	ふしん	fushin	dullness; depression; slump; stagnation
不順	ふじゅん	fujun	irregularity; unseasonableness
付属	ふぞく	fuzoku	attached; belonging; affiliated; annexed; associated; subordinate; incidental; dependent; auxiliary
負担	ふたん	futan	burden; charge; responsibility
不調	ふちょう	fuchou	bad condition; not to work out (ie a deal); disagreement; break-off; disorder; slump; out of form
復活	ふっかつ	fukkatsu	revival (e.g. musical); restoration
復興	ふっこう	fukkou	revival; renaissance; reconstruction
沸騰	ふっとう	futtou	boiling; seething
仏	ふつ	futsu	French
不図	ふと	futo	suddenly; casually; accidentally; incidentally; unexpectedly; unintentionally
不当	ふとう	futou	injustice; impropriety; unreasonableness; undeservedness; unfair; invalid
不動産	ふどうさん	fudousan	real estate
赴任	ふにん	funin	(proceeding to) new appointment
腐敗	ふはい	fuhai	decay; depravity
不評	ふひょう	fuhyou	bad reputation; disgrace; unpopularity
不便	ふびん	fubin	pity; compassion
不服	ふふく	fufuku	dissatisfaction; discontent; disapproval; objection; complaint; protest; disagreement
普遍	ふへん	fuhen	universality; ubiquity; omnipresence
踏まえる	ふまえる	fumaeru	to be based on; to have origin in
文	ふみ	fumi	letter; writings
不明	ふめい	fumei	unknown; obscure; indistinct; uncertain; ambiguous; ignorant; lack of wisdom; anonymous; unidentified
扶養	ふよう	fuyou	support; maintenance
振り	ふり	furi	pretence; show; appearance
振り出し	ふりだし	furidashi	outset; starting point; drawing or issuing (draft)
不良	ふりょう	furyou	badness; delinquent; inferiority; failure
浮力	ふりょく	furyoku	buoyancy; floating power
震わせる	ふるわせる	furuwaseru	to be shaking; to be trembling
付録	ふろく	furoku	appendix; supplement
分	ふん	fun	minute
憤慨	ふんがい	fungai	indignation; resentment
紛失	ふんしつ	funshitsu	losing something
噴出	ふんしゅつ	funshutsu	spewing; gushing; spouting; eruption; effusion
紛争	ふんそう	funsou	dispute; trouble; strife
	ふんだん	fundan	plentiful; abundant; lavish
奮闘	ふんとう	funtou	hard struggle; strenuous effort
粉末	ふんまつ	funmatsu	fine powder
部	ぶ	bu	department; part; category; counter for copies of a newspaper or magazine
部下	ぶか	buka	subordinate person
	ぶかぶか	bukabuka	too big; baggy
侮辱	ぶじょく	bujoku	insult; contempt; slight
武装	ぶそう	busou	arms; armament; armed
斑	ぶち	buchi	spots; speckles; mottles
物資	ぶっし	busshi	goods; materials
物体	ぶったい	buttai	body; object
物議	ぶつぎ	butsugi	public discussion (criticism)
打付ける	ぶつける	butsukeru	to knock; to run into; to nail on; to strike hard; to hit and attack
仏像	ぶつぞう	butsuzou	Buddhist image (statue)
無難	ぶなん	bunan	safety; security
部門	ぶもん	bumon	class; group; category; department; field; branch
ぶら下げる	ぶらさげる	burasageru	to hang; to suspend; to dangle; to swing
	ぶらぶら	burabura	dangle heavily; swing; sway to and fro; aimlessly; idly; lazily; loiter; loaf; be idle; stroll idly
武力	ぶりょく	buryoku	armed might; military power; the sword; force
無礼	ぶれい	burei	impolite; rude
文化財	ぶんかざい	bunkazai	cultural assets; cultural property
分業	ぶんぎょう	bungyou	division of labor; specialization; assembly-line production
文語	ぶんご	bungo	written language; literary language
分散	ぶんさん	bunsan	dispersion; decentralization; variance (statistics)
分子	ぶんし	bunshi	numerator; molecule
文書	ぶんしょ	bunsho	document; writing; letter; note; records; archives
分担	ぶんたん	buntan	apportionment; sharing
分配	ぶんぱい	bunpai	division; sharing
分母	ぶんぼ	bunbo	denominator
分離	ぶんり	bunri	separation; detachment; segregation; isolation
分裂	ぶんれつ	bunretsu	split; division; break up
兵器	へいき	heiki	arms; weapons; ordinance
閉口	へいこう	heikou	shut mouth
平行	へいこう	heikou	(going) side by side; concurrent; abreast; at the same time; occurring together; parallel; parallelism
閉鎖	へいさ	heisa	closing; closure; shutdown; lockout; unsociable
兵士	へいし	heishi	soldier
平常	へいじょう	heijou	normal; usual
平方	へいほう	heihou	square (e.g. metre); square
並列	へいれつ	heiretsu	arrangement; parallel; abreast
辟易	へきえき	hekieki	wince; shrink back; succumbing to; being frightened; disconcerted
臍	へそ	heso	navel; belly-button
隔たる	へだたる	hedataru	to be distant
謙る	へりくだる	herikudaru	to deprecate oneself and praise the listener
経る	へる	heru	to pass; to elapse; to experience
編	へん	hen	compilation; editing; completed poem; book; part of book
偏	へん	hen	side; left radical of a character; inclining; inclining toward; biased
変革	へんかく	henkaku	change; reform; revolution; upheaval; (the) Reformation
返還	へんかん	henkan	return; restoration
偏見	へんけん	henken	prejudice; narrow view
返済	へんさい	hensai	repayment
変遷	へんせん	hensen	change; transition; vicissitudes
返答	へんとう	hentou	reply
変動	へんどう	hendou	change; fluctuation
弁解	べんかい	benkai	explanation; justification; defence; excuse
便宜	べんぎ	bengi	convenience; accommodation; advantage; expedience
弁護	べんご	bengo	defense; pleading; advocacy
弁償	べんしょう	benshou	next word; compensation; reparation; indemnity; reimbursement
弁論	べんろん	benron	discussion; debate; argument
	ぺこぺこ	pekopeko	fawn; be very hungry
穂	ほ	ho	ear (of plant); head (of plant)
保育	ほいく	hoiku	nursing; nurturing; rearing; lactation; suckling
倣	ほう	hou	imitate; follow; emulate
法案	ほうあん	houan	bill (law)
崩壊	ほうかい	houkai	collapse; decay (physics); crumbling; breaking down; caving in
法学	ほうがく	hougaku	law; jurisprudence
放棄	ほうき	houki	abandonment; renunciation; abdication (responsibility right)
宝器	ほうき	houki	treasured article or vessel; outstanding individual
封建	ほうけん	houken	feudalistic
豊作	ほうさく	housaku	abundant harvest; bumper crop
方策	ほうさく	housaku	plan; policy
奉仕	ほうし	houshi	attendance; service
方式	ほうしき	houshiki	form; method; system
放射	ほうしゃ	housha	radiation; emission
放射能	ほうしゃのう	houshanou	radioactivity
報酬	ほうしゅう	houshuu	remuneration; recompense; reward; toll
放出	ほうしゅつ	houshutsu	release; emit
報じる/報ずる	ほうじる/ほうずる	houjiru/ houzuru	to inform; to report
放置	ほうち	houchi	leave as is; leave to chance; leave alone; neglect
法廷	ほうてい	houtei	courtroom
報道	ほうどう	houdou	information; report
褒美	ほうび	houbi	reward; prize
葬る	ほうむる	houmuru	to bury; to inter; to entomb; to consign to oblivion; to shelve
放り込む	ほうりこむ	hourikomu	to throw into
放り出す	ほうりだす	houridasu	to throw out; to fire; to expel; to give up; to abandon; to neglect
飽和	ほうわ	houwa	saturation
保温	ほおん	hoon	retaining warmth; keeping heat in; heat insulation
捕獲	ほかく	hokaku	capture; seizure
保管	ほかん	hokan	charge; custody; safekeeping; deposit; storage
補給	ほきゅう	hokyuu	supply; supplying; replenishment
補強	ほきょう	hokyou	compensation; reinforcement
保険	ほけん	hoken	insurance; guarantee
捕鯨	ほげい	hogei	whaling; whale fishing
誇る	ほこる	hokoru	to boast of; to be proud of
綻びる	ほころびる	hokorobiru	to come apart at the seams; to begin to open; to smile broadly
保護	ほご	hogo	care; protection; shelter; guardianship; favor; patronage
乾	ほし	hoshi	dried; cured
干し物	ほしもの	hoshimono	dried washing (clothes)
保守	ほしゅ	hoshu	conservative; maintaining
保障	ほしょう	hoshou	guarantee; security; assurance; pledge; warranty
補償	ほしょう	hoshou	compensation; reparation
補充	ほじゅう	hojuu	supplementation; supplement; replenishment; replenishing
補助	ほじょ	hojo	assistance; support; aid; auxiliary
舗装	ほそう	hosou	pavement; road surface
補足	ほそく	hosoku	supplement; complement
発作	ほっさ	hossa	fit; spasm
	ほっと	hotto	feel relieved
頬っぺた	ほっぺた	hoppeta	cheek
辺り	ほとり	hotori	(in the) neighbourhood; vicinity; nearby
殆ど	ほとんど	hotondo	mostly; almost
解く	ほどく	hodoku	to unfasten
施す	ほどこす	hodokosu	to donate; to give; to conduct; to apply; to perform
保母	ほぼ	hobo	day care worker in a kindergarten nursery school etc.
保養	ほよう	hoyou	health preservation; recuperation; recreation
捕吏	ほり	hori	constable
捕虜	ほりょ	horyo	prisoner (of war)
滅びる	ほろびる	horobiru	to be ruined; to go under; to perish; to be destroyed
滅ぼす	ほろぼす	horobosu	to destroy; to overthrow; to wreck; to ruin
本格	ほんかく	honkaku	propriety; fundamental rules
本館	ほんかん	honkan	main building
本気	ほんき	honki	seriousness; truth; sanctity
本質	ほんしつ	honshitsu	essence; true nature; reality
本体	ほんたい	hontai	substance; real form; object of worship
本音	ほんね	honne	real intention; motive
本の	ほんの	honno	mere; only; just
本能	ほんのう	honnou	instinct
本場	ほんば	honba	home; habitat; center; best place; genuine
本文	ほんぶん	honbun	text (of document); body (of letter)
本名	ほんみょう	honmyou	real name
卯	ぼう	bou	fourth sign of Chinese zodiac (The Hare 5am-7am east February)
防衛	ぼうえい	bouei	defense; protection; self-defense
防火	ぼうか	bouka	fire prevention; fire fighting; fire proof
妨害	ぼうがい	bougai	disturbance; obstruction; hindrance; jamming; interference
紡績	ぼうせき	bouseki	spinning
呆然	ぼうぜん	bouzen	dumbfounded; overcome with surprise; in blank amazement
膨脹	ぼうちょう	bouchou	expansion; swelling; increase; growth
冒頭	ぼうとう	boutou	beginning; start; outset
暴動	ぼうどう	boudou	insurrection; rebellion; revolt; riot; uprising
暴風	ぼうふう	boufuu	storm; windstorm; gale
暴力	ぼうりょく	bouryoku	violence
募金	ぼきん	bokin	fund-raising; collection of funds
牧師	ぼくし	bokushi	pastor; minister; clergyman
母校	ぼこう	bokou	alma mater
没収	ぼっしゅう	bosshuu	forfeited
坊ちゃん	ぼっちゃん	bocchan	son (of others)
	ぼつぼつ	botsubotsu	gradually; here and there; spots; pimples
没落	ぼつらく	botsuraku	ruin; fall; collapse
	ぼやく	boyaku	to grumble; to complain
	ぼやける	boyakeru	to become dim; to become blurred
藍褸	ぼろ	boro	rag; scrap; tattered clothes; fault (esp. in a pretense); defect; run-down or junky
枚	まい	mai	counter for flat objects (e.g. sheets of paper)
埋蔵	まいぞう	maizou	buried property; treasure trove
舞う	まう	mau	to dance; to flutter about; to revolve
真上	まうえ	maue	just above; right overhead
前売り	まえうり	maeuri	advance sale; booking
前置き	まえおき	maeoki	preface; introduction
前もって	まえもって	maemotte	in advance; beforehand; previously
任す	まかす	makasu	to entrust; to leave to a person
負かす	まかす	makasu	to defeat
賄う	まかなう	makanau	to give board to; to provide meals; to pay
曲がる	まがる	magaru	to turn; to bend
巻	まき	maki	volume
紛らわしい	まぎらわしい	magirawashii	confusing; misleading; equivocal; ambiguous
紛れる	まぎれる	magireru	to be diverted; to slip into
膜	まく	maku	membrane; film
捲る	まくる	makuru	verb suffix to indicate reckless abandon to the activity
真心	まこころ	makokoro	sincerity; devotion
誠	まこと	makoto	truth; faith; fidelity; sincerity; trust; confidence; reliance; devotion
真に	まことに	makotoni	truly; actually; really
	まごつく	magotsuku	to be confused; to be flustered
正しく	まさしく	masashiku	surely; no doubt; evidently
正に	まさに	masani	correctly; surely
勝る	まさる	masaru	to excel; to surpass; to outrival
増し	まし	mashi	extra; additional; less objectionable; better; preferable
真下	ました	mashita	right under; directly below
況して	まして	mashite	still more; still less (with neg. verb); to say nothing of; not to mention
交える	まじえる	majieru	to mix; to converse with; to cross (swords)
交わる	まじわる	majiwaru	to cross; to intersect; to associate with; to mingle with; to interest; to join
麻酔	ますい	masui	anaesthesia
益々	ますます	masumasu	increasingly; more and more
不味い	まずい	mazui	unappetising; unpleasant (taste appearance situation); ugly; unskilful; awkward; bungling; unwise; untime
股	また	mata	groin; crotch; thigh
跨がる	またがる	matagaru	to extend over or into; to straddle
跨ぐ	またぐ	matagu	to straddle
瞬き	またたき	matataki	wink; twinkling (of stars); flicker (of light)
待ち合わせ	まちあわせ	machiawase	appointment
間違う	まちがう	machigau	to make a mistake; to be incorrect; to be mistaken
待ち遠しい	まちどおしい	machidooshii	looking forward to
待ち望む	まちのぞむ	machinozomu	to look anxiously for; to wait eagerly for
区々	まちまち	machimachi	1. several; various; divergent; conflicting; different; diverse; 2. trivial
末期	まっき	makki	closing years (period days); last stage
真っ二つ	まっぷたつ	mapputatsu	in two equal parts
的	まと	mato	mark; target
纏まり	まとまり	matomari	conclusion; settlement; consistency
纏め	まとめ	matome	settlement; conclusion
免れる	まぬかれる	manukareru	to escape from; to be rescued from; to avoid; to evade; to avert; to elude; to be exempted; to be relieved
招き	まねき	maneki	invitation
麻痺	まひ	mahi	paralysis; palsy; numbness; stupor
眩しい	まぶしい	mabushii	dazzling; radiant
目蓋	まぶた	mabuta	eyelid
間々	まま	mama	occasionally; frequently
間もなく	まもなく	mamonaku	soon; before long; in a short time
眉	まゆ	mayu	eyebrow
鞠	まり	mari	ball
丸ごと	まるごと	marugoto	in its entirety; whole; wholly
丸っきり	まるっきり	marukkiri	completely; perfectly; just as if
丸で	まるで	marude	quite; entirely; completely; at all; as if; as though; so to speak
丸々	まるまる	marumaru	completely
丸める	まるめる	marumeru	to make round; to round off; to roll up; to curl up; to seduce; to cajole; to explain away
満月	まんげつ	mangetsu	full moon
満場	まんじょう	manjou	unanimous; whole audience
真ん中	まんなか	mannaka	middle; centre; mid-way
真ん前	まんまえ	manmae	right in front; under the nose
真ん丸い	まんまるい	manmarui	perfectly circular
三	み	mi	(num) three
見合い	みあい	miai	formal marriage interview
見合わせる	みあわせる	miawaseru	to exchange glances; to postpone; to suspend operations; to refrain from performing an action
見落とす	みおとす	miotosu	to overlook; to fail to notice
未開	みかい	mikai	savage land; backward region; uncivilized
味覚	みかく	mikaku	taste; palate; sense of taste
見掛ける	みかける	mikakeru	to (happen to) see; to notice; to catch sight of
三日月	みかずき	mikazuki	new moon; crescent moon
見方	みかた	mikata	viewpoint
見苦しい	みぐるしい	migurushii	unsightly; ugly
見込み	みこみ	mikomi	hope; prospects; expectation
未婚	みこん	mikon	unmarried
惨め	みじめ	mijime	miserable
未熟	みじゅく	mijuku	inexperience; unripeness; raw; unskilled; immature; inexperienced
微塵	みじん	mijin	particle; atom
見すぼらしい	みすぼらしい	misuborashii	shabby; seedy
見せびらかす	みせびらかす	misebirakasu	to show off; to flaunt
見せ物	みせもの	misemono	show; exhibition
満たす	みたす	mitasu	to satisfy; to ingratiate; to fill; to fulfill
乱す	みだす	midasu	to throw out of order; to disarrange; to disturb
乱れる	みだれる	midareru	to get confused; to be disordered; to be disturbed
未知	みち	michi	not yet known
導く	みちびく	michibiku	to be guided; to be shown
身近	みぢか	mijika	near oneself; close to one; familiar
密集	みっしゅう	misshuu	crowd; close formation; dense
密接	みっせつ	missetsu	related; connected; close; intimate
見っともない	みっともない	mittomonai	shameful; indecent
蜜	みつ	mitsu	nectar; honey
密度	みつど	mitsudo	density
見積り	みつもり	mitsumori	estimation; quotation
未定	みてい	mitei	not yet fixed; undecided; pending
見通し	みとおし	mitooshi	perspective; unobstructed view; outlook; forecast; prospect; insight
源	みなもと	minamoto	source; origin
身なり	みなり	minari	personal appearance
峰	みね	mine	peak; ridge
見逃す	みのがす	minogasu	to miss; to overlook; to leave at large
見晴らし	みはらし	miharashi	view
身振り	みぶり	miburi	gesture
見舞	みまい	mimai	enquiry; expression of sympathy; expression of concern
脈	みゃく	myaku	pulse
未練	みれん	miren	lingering affection; attachment; regret(s); reluctance
見渡す	みわたす	miwatasu	to look out over; to survey (scene); to take an extensive view of
民主	みんしゅ	minshu	democratic; the head of the nation
民宿	みんしゅく	minshuku	private home providing lodging for travelers
民族/民俗	みんぞく	minzoku	people; race; nation; racial customs; folk customs
六	む	mu	(num) six
無意味	むいみ	muimi	nonsense; no meaning
向き	むき	muki	direction; situation; exposure; aspect; suitability
無口	むくち	mukuchi	reticence
向け	むけ	muke	for ~; oriented towards ~
婿	むこ	muko	son-in-law
無効	むこう	mukou	invalid; no effect; unavailable
無言	むごん	mugon	silence
毟る	むしる	mushiru	to pluck; to pick; to tear
無邪気	むじゃき	mujaki	innocence; simple-mindedness
結び	むすび	musubi	ending; conclusion; union
結び付き	むすびつき	musubitsuki	connection; relation
結び付く	むすびつく	musubitsuku	to be connected or related; to join together
結び付ける	むすびつける	musubitsukeru	to combine; to join; to tie on; to attach with a knot
無線	むせん	musen	wireless; radio
無駄遣い	むだづかい	mudazukai	waste money on; squander money on; flog a dead horse
無断	むだん	mudan	without permission; without notice
無知	むち	muchi	ignorance
無茶	むちゃ	mucha	absurd; unreasonable; excessive; rash; absurdity; nonsense
無茶苦茶	むちゃくちゃ	muchakucha	confused; jumbled; mixed up; unreasonable
空しい	むなしい	munashii	vacant; futile; vain; void; empty; ineffective; lifeless
無念	むねん	munen	chagrin; regret
無能	むのう	munou	inefficiency; incompetence
無闇に	むやみに	muyamini	unreasonably; absurdly; recklessly; indiscreetly; at random
無用	むよう	muyou	useless; futility; needlessness; unnecessariness
群がる	むらがる	muragaru	to swarm; to gather
無論	むろん	muron	of course; naturally
名産	めいさん	meisan	noted product
名称	めいしょう	meishou	name
命中	めいちゅう	meichuu	a hit
名簿	めいぼ	meibo	register of names
名誉	めいよ	meiyo	honor; credit; prestige
明瞭	めいりょう	meiryou	clarity
明朗	めいろう	meirou	bright; clear; cheerful
目方	めかた	mekata	weight
恵み	めぐみ	megumi	blessing
恵む	めぐむ	megumu	to bless; to show mercy to
目覚しい	めざましい	mezamashii	brilliant; splendid; striking; remarkable
目覚める	めざめる	mezameru	to wake up
召す	めす	mesu	to call; to send for; to put on; to wear; to take (a bath); to ride in; to buy; to eat; to drink; to catch (a
雌	めす	mesu	female (animal)
滅茶苦茶	めちゃくちゃ	mechakucha	absurd; unreasonable; excessive; messed up; spoiled; wreaked
目付き	めつき	metsuki	look; expression of the eyes; eyes
滅亡	めつぼう	metsubou	downfall; ruin; collapse; destruction
愛でたい	めでたい	medetai	auspicious
目眩	めまい	memai	dizziness; giddiness
目盛	めもり	memori	scale; gradations
面会	めんかい	menkai	interview
免除	めんじょ	menjo	exemption; exoneration; discharge
面する	めんする	mensuru	to face on; to look out on to
面目	めんぼく	menboku	face; honour; reputation; prestige; dignity; credit
設ける	もうける	moukeru	to create; to establish
申し入れる	もうしいれる	moushiireru	to propose; to suggest
申し込み	もうしこみ	moushikomi	application; entry; request; subscription; offer; proposal; overture; challenge
申出	もうしで	moushide	proposal; request; claim; report; notice
申し出る	もうしでる	moushideru	to report to; to tell; to suggest; to submit; to request; to make an offer; to come forward with informati
申し分	もうしぶん	moushibun	objection; shortcomings
盲点	もうてん	mouten	blind spot
猛烈	もうれつ	mouretsu	violent; vehement; rage
藻掻く	もがく	mogaku	to struggle; to wriggle; to be impatient
目録	もくろく	mokuroku	catalogue; catalog; list
目論見	もくろみ	mokuromi	a plan; a scheme; a project; a program; intention; goal
模型	もけい	mokei	model; dummy; maquette
模索	もさく	mosaku	groping (for)
若し	もし	moshi	if; in case; supposing
若しかしたら	もしかしたら	moshikashitara	perhaps; maybe; by some chance
若しかして	もしかして	moshikashite	perhaps; possibly
若しかすると	もしかすると	moshikasuruto	perhaps; maybe; by some chance
若しくは	もしくは	moshikuha	or; otherwise
若しも	もしも	moshimo	if
齎らす	もたらす	motarasu	to bring; to take; to bring about
凭れる	もたれる	motareru	to lean against; to lean on; to recline on; to lie heavy (on the stomach)
持ち	もち	mochi	1. hold; charge; keep possession; in charge; 2. wear; durability; life; draw; 3. usage (suff)
持ち切り	もちきり	mochikiri	hot topic; talk of the town
物体ない	もったいない	mottainai	too good; more than one deserves; wasteful; sacrilegious; unworthy of
以て	もって	motte	with; by; by means of; because; in view of
専ら	もっぱら	moppara	wholly; solely; entirely
持て成す	もてなす	motenasu	to entertain; to make welcome
持てる	もてる	moteru	to be well liked; to be popular
基	もとい	motoi	basis
物置き	ものおき	monooki	storeroom
物好き	ものずき	monozuki	curiosity
物足りない	ものたりない	monotarinai	unsatisfied; unsatisfactory
最早	もはや	mohaya	already; now
模範	もはん	mohan	exemplar; exemplification; exemplum; model; example
模倣	もほう	mohou	imitation; copying
揉める	もめる	momeru	to disagree; to dispute
腿	もも	momo	thigh; femur
催す	もよおす	moyoosu	to hold (a meeting); to give (a dinner); to feel; to show signs of; to develop symptoms of; to feel (sick
漏らす	もらす	morasu	to let leak; to reveal
盛り上がる	もりあがる	moriagaru	to rouse; to swell; to rise
漏る	もる	moru	to leak; to run out
漏れる	もれる	moreru	to leak out; to escape; to come through; to shine through; to filter out; to be omitted
脆い	もろい	moroi	brittle; fragile; tender-hearted
	もろに	moroni	completely; all the way
問	もん	mon	problem; question
矢	や	ya	arrow
哉	や	ya	question mark
喧しい	やかましい	yakamashii	noisy; strict; fussy
野外	やがい	yagai	fields; outskirts; open air; suburbs
軈て	やがて	yagate	before long; soon; at length
夜行	やぎょう	yagyou	walking around at night; night train; night travel
役職	やくしょく	yakushoku	post; managerial position; official position
役立つ	やくだつ	yakudatsu	to be useful; to be helpful; to serve the purpose
役場	やくば	yakuba	town hall
夜具	やぐ	yagu	bedding
優	やさ	yasa	gentle; affectionate
屋敷	やしき	yashiki	mansion
養う	やしなう	yashinau	to rear; to maintain; to cultivate
社	やしろ	yashiro	Shinto shrine
野心	やしん	yashin	ambition; aspiration; designs; treachery
易い	やすい	yasui	easy
安っぽい	やすっぽい	yasuppoi	cheap-looking; tawdry; insignificant
休める	やすめる	yasumeru	to rest; to suspend; to give relief
野生	やせい	yasei	wild
矢鱈に	やたらに	yatarani	randomly; recklessly; blindly
夜中	やちゅう	yachuu	all night; the whole night
奴	やっこ	yakko	servant; fellow
やっ付ける	やっつける	yattsukeru	to beat
矢っ張り	やっぱり	yappari	also; as I thought; still; in spite of; absolutely
野党	やとう	yatou	opposition party
病	やまい	yamai	illness; disease
闇	やみ	yami	darkness; the dark; black-marketeering; dark; shady; illegal
病む	やむ	yamu	to fall ill; to be ill
止むを得ない	やむをえない	yamuoenai	cannot be helped; unavoidable
稍	やや	yaya	a little; partially; somewhat; a short time; a while
	ややこしい	yayakoshii	puzzling; tangled; complicated; complex
遣り通す	やりとおす	yaritoosu	to carry through; to achieve; to complete
やり遂げる	やりとげる	yaritogeru	to accomplish
遣る	やる	yaru	to do; to have sexual intercourse; to kill; to give (to inferiors animals etc.); to dispatch (a letter
和らげる	やわらげる	yawarageru	to soften; to moderate; to relieve
優位	ゆうい	yuui	predominance; ascendancy; superiority
憂鬱	ゆううつ	yuuutsu	depression; melancholy; dejection; gloom
有益	ゆうえき	yuueki	beneficial; profitable
優越	ゆうえつ	yuuetsu	supremacy; predominance; being superior to
勇敢	ゆうかん	yuukan	bravery; heroism; gallantry
有機	ゆうき	yuuki	organic
夕暮れ	ゆうぐれ	yuugure	evening; (evening) twilight
融資	ゆうし	yuushi	financing; loan
有する	ゆうする	yuusuru	to own; to be endowed with
融通	ゆうずう	yuuzuu	lending (money); accommodation; adaptability; versatility; finance
優勢	ゆうせい	yuusei	superiority; superior power; predominance; preponderance
優先	ゆうせん	yuusen	preference; priority
誘導	ゆうどう	yuudou	guidance; leading; induction; introduction; incitement; inducement
優美	ゆうび	yuubi	grace; refinement; elegance
有望	ゆうぼう	yuubou	good prospects; full of hope; promising
遊牧	ゆうぼく	yuuboku	nomadism
夕焼け	ゆうやけ	yuuyake	sunset
有力	ゆうりょく	yuuryoku	1. influence; prominence; 2. potent
幽霊	ゆうれい	yuurei	ghost; specter; apparition; phantom
誘惑	ゆうわく	yuuwaku	temptation; allurement; lure
揺さぶる	ゆさぶる	yusaburu	to shake; to jolt; to rock; to swing
茹でる	ゆでる	yuderu	to boil
	ゆとり	yutori	reserve; affluence; room; time (to spare)
指差す	ゆびさす	yubisasu	to point at
弓	ゆみ	yumi	bow (and arrow)
揺らぐ	ゆらぐ	yuragu	to swing; to sway; to shake; to tremble
緩む	ゆるむ	yurumu	to become loose; to slacken
緩める	ゆるめる	yurumeru	to loosen; to slow down
緩やか	ゆるやか	yuruyaka	lenient
世	よ	yo	world; society; age; generation
好い	よい	yoi	good
要因	よういん	youin	primary factor; main cause
溶液	ようえき	youeki	solution (liquid)
用件	ようけん	youken	business
養護	ようご	yougo	protection; nursing; protective care
用紙	ようし	youshi	blank form
様式	ようしき	youshiki	style; form; pattern
要する	ようする	yousuru	to demand; to require; to take
要請	ようせい	yousei	claim; demand; request; application
養成	ようせい	yousei	training; development
様相	ようそう	yousou	aspect
用品	ようひん	youhin	articles; supplies; parts
洋風	ようふう	youfuu	western style
用法	ようほう	youhou	directions; rules of use
要望	ようぼう	youbou	demand for; request
余暇	よか	yoka	leisure; leisure time; spare time
予感	よかん	yokan	presentiment; premonition
余興	よきょう	yokyou	side show; entertainment
預金	よきん	yokin	deposit; bank account
抑圧	よくあつ	yokuatsu	check; restraint; oppression; suppression
浴室	よくしつ	yokushitsu	bathroom; bath
抑制	よくせい	yokusei	suppression
欲深い	よくふかい	yokufukai	greedy
欲望	よくぼう	yokubou	desire; appetite
寄こす	よこす	yokosu	to send; to forward
横綱	よこづな	yokozuna	sumo grand champion
葦	よし	yoshi	reed; bulrush
善し悪し	よしあし	yoshiashi	good or bad; merits or demerits; quality; suitability
予想	よそう	yosou	expectation; anticipation; prediction; forecast
余所見	よそみ	yosomi	looking away; looking aside
余地	よち	yochi	place; room; margin; scope
依って	よって	yotte	therefore; consequently; accordingly; because of
余程	よっぽど	yoppodo	very; greatly; much; to a large extent; quite
与党	よとう	yotou	government party; (ruling) party in power; government
呼び止める	よびとめる	yobitomeru	to challenge; to call somebody to halt
夜更かし	よふかし	yofukashi	staying up late; keeping late hours; sitting up late at night; nighthawk
夜更け	よふけ	yofuke	late at night
読み上げる	よみあげる	yomiageru	to read out loud (and clearly); to call a roll
寄り掛かる	よりかかる	yorikakaru	to lean against; to recline on; to lean on; to rely on
宜しく	よろしく	yoroshiku	well; properly; suitably; best regards; please remember me
弱まる	よわまる	yowamaru	to abate; to weaken; to be emaciated; to be dejected; to be perplexed
弱める	よわめる	yowameru	to weaken
弱る	よわる	yowaru	to weaken; to be troubled; to be downcast; to be emaciated; to be dejected; to be perplexed; to impair
来場	らいじょう	raijou	attendance
酪農	らくのう	rakunou	dairy (farm)
落下	らっか	rakka	fall; drop; come down
楽観	らっかん	rakkan	optimism
濫用	らんよう	ranyou	abuse; misuse; misappropriation; using to excess
理屈	りくつ	rikutsu	theory; reason
利根	りこん	rikon	intelligence
利子	りし	rishi	interest (bank)
利潤	りじゅん	rijun	profit; returns
理性	りせい	risei	reason; sense
利息	りそく	risoku	interest (bank)
立体	りったい	rittai	solid body
立法	りっぽう	rippou	legislation; lawmaking
利点	りてん	riten	advantage; point in favor
略語	りゃくご	ryakugo	abbreviation; acronym
略奪	りゃくだつ	ryakudatsu	pillage; plunder; looting; robbery
流	りゅう	ryuu	styleof; method of; manner of
流通	りゅうつう	ryuutsuu	circulation of money or goods; flow of water or air; distribution
了	りょう	ryou	finish; completion; understanding
料	りょう	ryou	material; charge; rate; fee
領域	りょういき	ryouiki	area; domain; territory; field; region; regime
了解	りょうかい	ryoukai	comprehension; consent; understanding; roger (on the radio)
領海	りょうかい	ryoukai	territorial waters
両極	りょうきょく	ryoukyoku	both extremities; north and south poles; positive and negative poles
良好	りょうこう	ryoukou	favorable; satisfactory
良識	りょうしき	ryoushiki	good sense
良質	りょうしつ	ryoushitsu	good quality; superior quality
了承	りょうしょう	ryoushou	acknowledgement; understanding (e.g. please be understanding of the mess during our renovation)
良心	りょうしん	ryoushin	conscience
領地	りょうち	ryouchi	territory; dominion
領土	りょうど	ryoudo	dominion; territory; possession
両立	りょうりつ	ryouritsu	compatibility; coexistence; standing together
旅客	りょかく	ryokaku	passenger (transport)
旅券	りょけん	ryoken	passport
履歴	りれき	rireki	personal history; background; career; log
理論	りろん	riron	theory
輪	りん	rin	counter for wheels and flowers
林業	りんぎょう	ringyou	forestry
類似	るいじ	ruiji	analogous
類推	るいすい	ruisui	analogy
冷酷	れいこく	reikoku	cruelty; coldheartedness; relentless; ruthless
冷蔵	れいぞう	reizou	cold storage; refrigeration
冷淡	れいたん	reitan	coolness; indifference
恋愛	れんあい	renai	love; love-making; passion; emotion; affections
連休	れんきゅう	renkyuu	consecutive holidays
連日	れんじつ	renjitsu	every day; prolonged
連中	れんじゅう	renjuu	colleagues; company; a lot
連帯	れんたい	rentai	solidarity
連邦	れんぽう	renpou	commonwealth; federation of states
連盟	れんめい	renmei	league; union; alliance
老衰	ろうすい	rousui	senility; senile decay
朗読	ろうどく	roudoku	reading aloud; recitation
浪費	ろうひ	rouhi	waste; extravagance
労力	ろうりょく	rouryoku	labour; effort; toil; trouble
碌な	ろくな	rokuna	satisfactory; decent
碌に	ろくに	rokuni	well; enough; sufficient
露骨	ろこつ	rokotsu	1. frank; blunt; plain; outspoken; 2. conspicuous; open; 3. broad; suggestive
論議	ろんぎ	rongi	discussion
論理	ろんり	ronri	logic
和	わ	wa	sum; harmony; peace
我がまま	わがまま	wagamama	selfishness; egoism; wilfulness; disobedience; whim
枠	わく	waku	frame; slide
惑星	わくせい	wakusei	planet
技	わざ	waza	art; technique
態と	わざと	wazato	on purpose
態々	わざわざ	wazawaza	expressly; specially; doing something especially rather than incidentally
煩わしい	わずらわしい	wazurawashii	troublesome; annoying; complicated
渡り鳥	わたりどり	wataridori	migratory bird; bird of passage
詫び	わび	wabi	apology
和風	わふう	wafuu	Japanese style
和文	わぶん	wabun	Japanese text; sentence in Japanese
藁	わら	wara	straw
割合に	わりあいに	wariaini	comparatively
割り当て	わりあて	wariate	allotment; assignment; allocation; quota; rationing
割り込む	わりこむ	warikomu	to cut in; to thrust oneself into; to wedge oneself in; to muscle in on; to interrupt; to disturb
割り算	わりざん	warizan	division (math)
割引き	わりびき	waribiki	discount; reduction; rebate; tenths discounted
悪者	わるもの	warumono	bad fellow; rascal; ruffian; scoundrel
	アイデア	aidea	idea
	アクセル	akuseru	accelerator
	アップ	apu	up
	アプローチ	apuroochi	approach (in golf)
	アマチュア	amachua	amateur
	アラブ	arabu	Arab
	アルカリ	arukari	alkali
	アルミ	arumi	aluminum (Al); aluminium
	アワー	awaa	hour
	アンケート	ankeeto	(fr:) (n) questionnaire (fr: enquete); survey
	アンコール	ankooru	encore
	イエス	iesu	Jesus; yes
	インターチェンジ	intaachenji	interchange
	インターナショナル	intaanashonaru	international
	インターフォン	intaafon	intercom
	インテリ	interi	egghead; intelligentsia
	インフォメーション	infomeeshon	information
	インフレ	infure	inflation
	ウェートレス	weetoresu	waitress
	エアメール	eameeru	air mail
	エレガント	ereganto	elegant
	エンジニア	enjinia	engineer
	オーケー	ookee	OK
	オートマチック	ootomachikku	automatic
	オープン	oopun	open
	オリエンテーション	orienteeshon	orientation
	オレンジ	orenji	an orange
	オンライン	onrain	on-line
	カーペット	kaapetto	carpet
	カクテル	kakuteru	cocktail
	カット	katto	cut; cutting
	カテゴリー	kategorii	category
	カムバック	kamubakku	comeback
	カメラマン	kameraman	cameraman
	カルテ	karute	(de:) (n) clinical records (de: Karte)
	カンニング	kanningu	cunning; cheat
	ガイド	gaido	tour guide
	ガイドブック	gaidobukku	guidebook
	ガレージ	gareeji	garage (at house)
	キャッチ	kyacchi	catch
	キャリア	kyaria	career; career government employee
	クイズ	kuizu	quiz
	クラブ	kurabu	club; crab
	クレーン	kureen	crane
	グラフ	gurafu	graph
	グレー	guree	grey; gray
	ゲスト	gesuto	guest
	コーナー	koonaa	corner
	コマーシャル	komaasharu	a commercial
	コミュニケーション	komyunikeeshon	communication
	コメント	komento	comment
	コンタクト	kontakuto	contact; contact lens
	コンテスト	kontesuto	contest
	コントラスト	kontorasuto	contrast
	コントロール	kontorooru	control
	コンパス	konpasu	compass
	サイクル	saikuru	cycle
	サイズ	saizu	size
	サボる	saboru	to be truant; to be idle; to sabotage by slowness
	サンキュー	sankyuu	thank you
	サンタクロース	santakuroosu	Santa Claus
	シート	shiito	seat; sheet
	システム	shisutemu	system
	シック	shikku	chic
	シナリオ	shinario	scenario
	ショー	shoo	show
	ショック	shokku	shock
	ジーパン	jiipan	jeans (lit: jeans pants); dungarees
	ジャズ	jazu	jazz
	ジャンパー	janpaa	jacket; jumper
	ジャンプ	janpu	jump
	ジャンボ	janbo	jumbo
	ジャンル	janru	genre
	スタジオ	sutajio	studio
	スチーム	suchiimu	steam
	ストライキ	sutoraiki	strike
	ストレス	sutoresu	stress
	ストロー	sutoroo	straw
	ストロボ	sutorobo	stroboscope (lit: strobo); strobe lamp; stroboscopic lamp
	スピード	supiido	speed
	スプリング	supuringu	spring
	スペース	supeesu	space
	スポーツカー	supootsukaa	sports car
	スラックス	surakkusu	slacks
	セール	seeru	sale
	セクション	sekushon	section
	セックス	sekkusu	sexual intercourse
	セレモニー	seremonii	ceremony
	センス	sensu	good sense (for music style tact etc.)
	ゼリー	zerii	1. jelly; 2. Jerry
	ソース	soosu	source
	ソックス	sokkusu	socks
	ソロ	soro	solo
	タイトル	taitoru	title
	タイピスト	taipisuto	typist
	タイマー	taimaa	timer
	タイミング	taimingu	timing
	タイム	taimu	time
	タイムリー	taimurii	timely; run-batted-in (baseball); RBI
	タイヤ	taiya	tire; tyre
	タイル	tairu	tile
	タレント	tarento	talent; star; personality
	タワー	tawaa	tower
	ダース	daasu	dozen
	ダウン	daun	down
	ダブる	daburu	to coincide (fall on the same day); to have two of something; to repeat a school year after failing
	ダンプ	danpu	dump
	チームワーク	chiimuwaaku	teamwork
	チェンジ	chenji	change
	チャイム	chaimu	chime
	チャンネル	channeru	a channel
	ティッシュペーパー	tisshupeepaa	tissue paper
	テレックス	terekkusu	telex; teletypewriter exchange
	データ	deeta	data
	デコレーション	dekoreeshon	decoration
	デザート	dezaato	dessert
	デザイン	dezain	design
	デッサン	dessan	(fr:) (n) rough sketch (fr: dessin)
	デモンストレーション	demonsutoreeshon	demonstration
	トーン	toon	tone
	トラブル	toraburu	trouble (sometimes used as a verb)
	トランジスター	toranjisutaa	transistor
	ドライ	dorai	dry
	ドライクリーニング	doraikuriiningu	dry cleaning
	ドライバー	doraibaa	driver; screwdriver
	ドライブイン	doraibuin	drive in
	ドリル	doriru	drill
	ナイター	naitaa	game under lights (e.g. baseball) (lit: nighter); night game
	ナプキン	napukin	napkin
	ナンセンス	nansensu	nonsense
	ニュー	nyuu	new
	ニュアンス	nyuansu	nuance
	ネガ	nega	(photographic) negative
	ノイローゼ	noirooze	(de:) (n) neurosis (de: Neurose)
	ハンガー	hangaa	hangar; (coat) hanger; hunger
	バー	baa	bar
	バッジ	bajji	badge
	バット	batto	bat; vat
	パジャマ	pajama	pajamas; pyjamas
	パチンコ	pachinko	pachinko (Japanese pinball)
	パトカー	patokaa	patrol car
	パンク	panku	1. (abbr) puncture; bursting; 2. punk
	ヒント	hinto	hint
	ビールス	biirusu	virus
	ビジネス	bijinesu	business
	ファイト	faito	fight
	ファイル	fairu	file
	ファン	fan	fan; fun
	フィルター	firutaa	(camera) filter
	フェリー	ferii	ferry
	フォーム	foomu	foam; form
	フロント	furonto	front
	ブーツ	buutsu	boots
	ブーム	buumu	boom
	ブザー	buzaa	buzzer
	ブルー	buruu	blue
	ベース	beesu	base; bass
	ベスト	besuto	best; vest
	ベストセラー	besutoseraa	best-seller
	ペア	pea	pair; pear
	ホース	hoosu	hose
	ホール	hooru	hall; hole
	ボイコット	boikotto	boycott
	ボルト	boruto	volt; bolt
	ポーズ	poozu	pause
	ポイント	pointo	point
	ポジション	pojishon	position
	ポット	potto	pot
	ポンプ	ponpu	pump
	マーク	maaku	mark
	マスコミ	masukomi	mass communication
	マッサージ	massaaji	massage
	ミスプリント	misupurinto	misprint
	ミセス	misesu	Mrs.
	ミュージック	myuujikku	music
	ミリ	miri	milli-; 10^-3
	ムード	muudo	mood
	メーカー	meekaa	maker
	メッセージ	messeeji	message
	メディア	media	media
	メロディー	merodii	melody
	モーテル	mooteru	motel
	モニター	monitaa	(computer) monitor
	ヤング	yangu	young
	ユニーク	yuniiku	unique
	ユニフォーム	yunifoomu	uniform
	ライス	raisu	rice
	ラベル	raberu	label
	ランプ	ranpu	lamp; ramp; headlight; light
	ルーズ	ruuzu	loose
	ルール	ruuru	rule
	レース	reesu	race; lace
	レギュラー	regyuraa	regular
	レクリエーション	rekurieeshon	recreation
	レッスン	ressun	lesson
	レディー	redii	lady
	レバー	rebaa	lever; liver
	レンジ	renji	range; stove
	レンタカー	rentakaa	hire car (lit: rent-a-car)
	レントゲン	rentogen	X-ray (lit: Roentgen)
	ロープ	roopu	rope
ローマ字	ローマじ	roomaji	romanization; Roman letters
	ロマンチック	romanchikku	romantic
	ワット	watto	watt