嗚呼	ああ	aa	Ах!; О!; Увы !
相	あい	ai	вместе; взаимно 
相変わらず	あいかわらず	aikawarazu	как всегда; как обычно
愛想	あいそ	aiso	вежливость; учтивость; комплименты; коммуникабельность
相対	あいたい	aitai	противостояние; тет -а- тет
間柄	あいぞう	aidagara	отношения; взаимоотношения; родство
愛憎	あいにく	aizou	любовь и ненависть
合間	あいま	aima	интервал
曖昧	あいまい	aimai	расплывчато; неоднозначно
敢えて	あえて	aete	осмелится
仰ぐ	あおぐ	aogu	уважать; зависить от; просить 
垢	あか	aka	грязь; мерзость
亜科	あか	aka	подотряд; подсемейство
銅	あかがね	akagane	медь
証	あかし	akashi	доказательство; свидетельство
赤字	あかじ	akaji	дефицит 
明かす	あかす	akasu	показать; разглашать
赤ちゃん	あかちゃん	akachan	ребенок; младенец
明白	あからさま	akarasama	очевидно; открыто; прямо; откровенно
赤らむ	あからむ	akaramu	краснеть
明るい	あかるい	akarui	яркий; веселый
上がり	あがり	agari	склон; доход; урожайность; подъем; завершение
上がる	あがる	agaru	войти; подняться; двигаться вперед; улучшить 
商人	あきうど	akiudo	трейдер; продавец
空間	あきま	akima	вакансия; комната в аренду 
諦め	あきらめ	akirame	отставка; принятие; утешение
呆れる	あきれる	akireru	удивляться; быть шокированым
悪	あく	aku	зло; 
灰	あく	aku	пепел; зола
	あくどい	akudoi	яркие; чрезмерный 
悪日	あくび	akubi	неудачный день
明くる	あくる	akuru	следующий; после
憧れ	あこがれ	akogare	тоска; стремление
顎	あご	ago	подбородок
麻	あさ	asa	лен; конопля
明後日	あさって	asatte	послезавтра
朝寝坊	あさねぼう	asanebou	спать допоздна
浅ましい	あさましい	asamashii	несчастный; жалкий; стыдно; презренный; 
字	あざ	aza	часть населённого пункта с собственным названием
欺く	あざむく	azamuku	обмануть
鮮やか	あざやか	azayaka	яркий; блестящий
あざ笑う	あざわらう	azawarau	насмехаться над 
味わい	あじわい	ajiwai	вкус; смысл; значение
東	あずま	azuma	восток; восточная Япония
焦る	あせる	aseru	быть в спешке; быть нетерпеливым
彼処	あそこ	asoko	там; что место
値	あたい	atai	значение; цена; стоимость
値する	あたいする	ataisuru	стоить; заслужить; 
私	あたし	atashi	я (женский вариант)
当たり	あたり	atari	попадание; успех; окрестности; район
当たり前	あたりまえ	atarimae	обычно; естественно; разумно; очевидно
他人	あだびと	adabito	другой человек; посторонний
彼方此方	あちこち	achikochi	там и сям
彼方	あちら	achira	там; вон там 
彼方此方	あちらこちら	achirakochira	там и сям
悪化	あっか	akka	ухудшение; обострение 
呆気ない	あっけない	akkenai	неинтересный; разочаровывающий; слишком простой
悪口	あっこう	akkou	насилие; оскорбление; клевета; злоречие
	あっさり	assari	легко; легко; быстро
圧迫	あっぱく	appaku	давление; принуждение; угнетение
扱い	あつかい	atsukai	лечение; обслуживание
集まる	あつまる	atsumaru	собирать
誂える	あつらえる	atsuraeru	отдать приказ; разместить заказ
圧力	あつりょく	atsuryoku	стресс; давление
当て	あて	ate	объект; цель; надежды; ожидания
宛	あて	ate	на имя
当て字	あてじ	ateji	фонетически использованный иероглиф
当てはまる	あてはまる	atehamaru	применять (правило)
当てはめる	あてはめる	atehameru	применяться; адаптировать
宛てる	あてる	ateru	по адресу
跡継ぎ	あとつぎ	atotsugi	наследник; преемник
後回し	あとまわし	atomawashi	отстрочка; откладывая
貴女	あなた	anata	вы (обращение к женщине)
彼の	あの	ano	что там
溢れる	あふれる	afureru	затопить; переполнить; переливаться через край
油絵	あぶらえ	aburae	живопись масляными красками
炙る	あぶる	aburu	палить
	あべこべ	abekobe	напротив; вверх ногами
甘える	あまえる	amaeru	вести себя как избалованный ребенок 
甘口	あまくち	amakuchi	лесть 
雨具	あまぐ	amagu	защита от дождя
天	あまつ	amatsu	небесный; имперский
網	あみ	ami	сеть
天地	あめつち	ametsuchi	небо и земля; вселенная; природа; сверху и снизу; царство; сфера; мир
操る	あやつる	ayatsuru	манипулировать; управлять
	あやふや	ayafuya	неопределенный; расплывчатый; неоднозначный
危ぶむ	あやぶむ	ayabumu	бояться; сомневаться
過ち	あやまち	ayamachi	ошибка; неосторожность
誤る	あやまる	ayamaru	ошибаться
歩み	あゆみ	ayumi	ходьба
歩む	あゆむ	ayumu	ходить пешком
	あら	ara	ой; ах; морской окунь
予め	あらかじめ	arakajime	заранее; ранее
荒らす	あらす	arasu	опустошать; разорять; портить; не следить; запускать
粗筋	あらすじ	arasuji	наброски; резюме
争い	あらそい	arasoi	спор; ссора; разногласия; конфликт; соперничество
改まる	あらたまる	aratamaru	меняться,обновляться; исправляться; улучшаться
荒っぽい	あらっぽい	arappoi	грубо
凡ゆる	あらゆる	arayuru	все; каждый
	あられ	arare	град; что-л. мелко нарезанное
現われ	あらわれ	araware	воплощение; материализация
現われる	あらわれる	arawareru	появляться; прийти в поле зрения; стать видимым; выйти; материализоваться; выразить себя
有難う	ありがとう	arigatou	спасибо
有様	ありさま	arisama	состояние; обстоятельства; способ; правда
有りのまま	ありのまま	arinomama	правда; факт; честно говоря
或る	ある	aru	определенный; некоторый
或いは	あるいは	aruiwa	или; возможно; 
彼此	あれこれ	arekore	одно или другое; то и это; то или иное
合わす	あわす	awasu	быть напротив; объединить; соединить; добавить до 
合わせ	あわせ	awase	соединение
慌ただしい	あわただしい	awatadashii	занятый; поспешный; запутанный; взбудораженный
慌てる	あわてる	awateru	запутать; приводить в замешательство 
暗殺	あんさつ	ansatsu	убийство
暗算	あんざん	anzan	счет в уме
暗示	あんじ	anji	намек; предложение
案じる	あんじる	anjiru	тревожиться; обдумвыать
安静	あんせい	ansei	остальные
案の定	あんのじょう	annojou	конечно же; как обычно
余り	あんまり	anmari	не очень (только в качестве наречия); не так много; остаток; излишек; баланс
依	い	i	зависимость (в сочетаниях)
良い	いい	ii	хорошо
否	いいえ	iie	нет
いい加減	いいかげん	iikagen	умеренный; в меру; подходящий; правильный
言い訳	いいわけ	iiwake	извинение; объяснение
家出	いえで	iede	выход из дома
家主	いえぬし	ienushi	домовладелец
如何	いかが	ikaga	как; каким образом
生かす	いかす	ikasu	возродить; реанимировать; чтобы использовать из
雷	いかずち	ikazuchi	гром
如何に	いかに	ikani	как?; то каким образом?; сколько?
如何にも	いかにも	ikanimo	действительно; фраза означающая согласие
怒り	いかり	ikari	гнев; ненависть
怒る	いかる	ikaru	сердиться; злиться
歪む	いがむ	igamu	деформировать; свернуть; сгибать 
粋	いき	iki	суть; квинтэссенция; лучшее; утончённость; деликатность 
域外	いきがい	ikigai	вне зоны
意気込む	いきごむ	ikigomu	быть в восторге
経緯	いきさつ	ikisatsu	детали; последовательность событий; обстоятельства
行き違い	いきちがい	ikichigai	недоразумение; разногласия 
行き成り	いきなり	ikinari	вдруг
異議	いぎ	igi	возражение; несогласие; протест
	いく	iku	прийти 
軍/戦	いくさ	ikusa	война; сражение; кампания; борьба
育成	いくせい	ikusei	разведение; обучение; воспитание; выращивание; продвижение
幾多	いくた	ikuta	многие; многочисленные
活ける	いける	ikeru	оживлять; использовать наилучшим образом
異見	いけん	iken	другое мнение; возражение
意向	いこう	ikou	намерение; идея; наклон
移行	いこう	ikou	переход на
	いざ	iza	ну-ка,ну; критический момент
碑	いしぶみ	ishibumi	каменный монумент с надписью
衣装	いしょう	ishou	одежда; костюм; снаряжение
意地	いじ	iji	дух; сила воли; упрямство 
苛める	いじめる	ijimeru	дразнить; мучить 
移住	いじゅう	ijuu	миграция; иммиграция
弄る	いじる	ijiru	вертеть в руках; трогать; играть с чем-л.; возиться
何れ	いずれ	izure	которые; так или иначе; во всяком случае
異性	いせい	isei	противоположный пол
遺跡	いせき	iseki	руины 
依然	いぜん	izen	тем не менее; до сих пор
依存	いそん	ison	зависимость 
委託	いたく	itaku	предать; поручить; совершить
悪戯	いたずら	itazura	шалость; шутка; озорство
頂	いただき	itadaki	вершина; верхушка; пик
戴きます	いただきます	itadakimasu	выражение благодарности перед едой
至って	いたって	itatte	очень; чрезвычайно 
痛む	いたむ	itamu	болеть; чувствовать боль; 
痛める	いためる	itameru	ранить; причинить боль 
炒める	いためる	itameru	жарить
労る	いたわる	itawaru	жалеть; сочувствовать; утешать; заботиться; быть добрым к
市	いち	ichi	рынок
位地	いち	ichi	место; ситуация; должность; позиция
一々	いちいち	ichiichi	один за другим; отдельно
一概に	いちがいに	ichigaini	безусловно; как правило
一見	いちげん	ichigen	взглянуть; бросить взгляд
一言	いちげん	ichigen	одно слово
一日	いちじつ	ichijitsu	в один прекрасный день; первое числа месяца; 
一定	いちじょう	ichijou	фиксированный; регламентированный; определенный; стандартизированый
著しい	いちじるしい	ichijirushii	примечательный; значительный
一同	いちどう	ichidou	все (мы,они,вы)
一人	いちにん	ichinin	один человек
一部	いちぶ	ichibu	 один экземпляр (например,документа); часть 
一部分	いちぶぶん	ichibubun	часть
一別	いちべつ	ichibetsu	расставание
一面	いちめん	ichimen	одна сторона; одна фаза; главная страница; с другой стороны; вся поверхность
一目	いちもく	ichimoku	взгляд; проблеск
一様	いちよう	ichiyou	однородность; ровность; подобие; равенство; беспристрастность
一律	いちりつ	ichiritsu	ровность; однородность; однообразие; равенство
一連	いちれん	ichiren	серия; цепочка 
一括	いっかつ	ikkatsu	все вместе; партия; один комок; один пучок; подводя итоги
一気	いっき	ikki	о дним духом; залпом
一挙に	いっきょに	ikkyoni	одним махом; с одной махом
一切	いっさい	issai	все; без исключения; весь; целиком; абсолютно
一心	いっしん	isshin	всем сердце
	いっそ	isso	скорее; 
一帯	いったい	ittai	область; зона 
一敗	いっぱい	ippai	поражение
一変	いっぺん	ippen	полное изменение; поворот кругом
何時	いつ	itsu	когда; как скоро
何時か	いつか	itsuka	когда-то; когда-нибудь; в один прекрасный день; рано или поздно 
何時でも	いつでも	itsudemo	в любое время; всегда; во все времена; никогда (с отрицанием) 
何時の間にか	いつのまにか	itsunomanika	незаметно; мгновенно
何時までも	いつまでも	itsumademo	навсегда; навечно; бесконечно
何時も	いつも	itsumo	всегда; каждый раз; когда; никогда (с нег . глагол)
意図	いと	ito	намерение ; цель
営む	いとなむ	itonamu	вести (например,церемонию); начать бизнес
暇	いとま	itoma	свободное время; отдых; отпуск
異動	いどう	idou	изменение
挑む	いどむ	idomu	бросить вызов; бороться за 
稲光	いなびかり	inabikari	(вспышка) молния
古	いにしえ	inishie	древность
祈り	いのり	inori	молитва
鼾	いびき	ibiki	храп
今更	いまさら	imasara	сейчас; в этот поздний час
未だ	いまだ	imada	пока еще; до сих пор; пока не (с отрицанием)
移民	いみん	imin	эмиграция; иммиграция; эмигрант; иммигрант
厭々	いやいや	iyaiya	неохотно; скрепя сердцем
卑しい	いやしい	iyashii	жадный; вульгарный; мерзкий
	いやに	iyani	ужасно 
厭やらしい	いやらしい	iyarashii	отвратительный; неприятный
愈々	いよいよ	iyoiyo	все больше и больше; тем более; более; наконец; вне всякого сомнения; 
意欲	いよく	iyoku	желание; амбиции
苛々	いらいら	iraira	нервный; раздраженный
入口	いりくち	irikuchi	вход; ворота
衣料	いりょう	iryou	одежда
威力	いりょく	iryoku	мощность; мощь; власть; влияние
入る	いる	iru	входить; вступать; садиться (о солнце); достигать
衣類	いるい	irui	одежда
色々	いろいろ	iroiro	различный
異論	いろん	iron	другое мнение; возражение
所謂	いわゆる	iwayuru	так называемый; так сказать
印	いん	in	печать; штамп; знак; печать
員	いん	in	член
印鑑	いんかん	inkan	печать 
陰気	いんき	inki	мрак; тоска
隠居	いんきょ	inkyo	выход на пенсию; пенсионер
上下	うえした	ueshita	высокое и низкое; вверх и вниз; разгрузка и погрузка 
浮かぶ	うかぶ	ukabu	плавать; подниматься на поверхность; приходить на ум
受かる	うかる	ukaru	выдержать (экзамен)
含嗽	うがい	ugai	полоскание; прополоскать рот
受け入れ	うけいれ	ukeire	получение; принятие
受け入れる	うけいれる	ukeireru	принять; получить
受け継ぐ	うけつぐ	uketsugu	принимать (в качестве преемника)
受け付ける	うけつける	uketsukeru	быть принятым
受け止める	うけとめる	uketomeru	поймать; остановить удар 
受け取り	うけとり	uketori	квитанция
受身	うけみ	ukemi	пассивность; пассивный залог
動き	うごき	ugoki	движение; активность; тенденция; развитие; изменение
潮	うしお	ushio	волна
氏	うじ	uji	фамилия
渦	うず	uzu	водоворот
埋まる	うずまる	uzumaru	быть похороненным; быть переполненым; быть заполненым
嘘つき	うそつき	usotsuki	врун; выдумщик
打ち合わせ	うちあわせ	uchiawase	деловая встреча; предыдущая договоренность; назначение
打ち合わせる	うちあわせる	uchiawaseru	организовать
打ち切る	うちきる	uchikiru	остановить; прервать; прекратить; закрыть
打ち消し	うちけし	uchikeshi	отрицание 
打ち込む	うちこむ	uchikomu	вбивать; вгонять; всаживать; вонзать
団扇	うちわ	uchiwa	вентилятор
内訳	うちわけ	uchiwake	элементы; распад; классификация
訴え	うったえ	uttae	мск; жалоба
鬱陶しい	うっとうしい	uttoushii	мрачный
写し	うつし	utsushi	копия 
空ろ	うつろ	utsuro	пустой; полость
器	うつわ	utsuwa	емкость; контейнер
雨天	うてん	uten	дождливая погода
腕前	うでまえ	udemae	способность; мастерство; 
饂飩	うどん	udon	лапша удон
促す	うながす	unagasu	вынуждат; понуждать; способствовать
唸る	うなる	unaru	стонать; реветь; выть; рычать; урчать; гудеть 
自惚れ	うぬぼれ	unubore	самовлюблённость; высокомерие
甘い	うまい	umai	вкусный
生まれつき	うまれつき	umaretsuki	по своей природе; от рождения
海路	うみじ	umiji	морской путь
産む	うむ	umu	рожать; чтобы поставить; чтобы произвести
埋め込む	うめこむ	umekomu	похоронить
梅干	うめぼし	umeboshi	сушеные сливы
末	うら	ura	верхушка; кончик
裏返し	うらがえし	uragaeshi	наизнанку; с ног на голову
売り出し	うりだし	uridashi	продажа
売り出す	うりだす	uridasu	поставить на продажу; на рынок; стать популярным
潤う	うるおう	uruou	становиться влажным; промокать; получать прибыль
五月蝿い	うるさい	urusai	шумный; громкий; суетливый
売れ行き	うれゆき	ureyuki	реализация; продажа
浮気	うわき	uwaki	легкомысленность; непостоянство; ветренность; бессмысленность
上手	うわて	uwate	верхняя часть; верховье (реки); наветренная сторона; превосходство (в умении и т.п.)
上回る	うわまわる	uwamawaru	превышать
植わる	うわる	uwaru	быть посаженым (о растении)
運営	うんえい	unei	управление; администрирование; эксплуатация
	うんざり	unzari	утомительно; скучно
運送	うんそう	unsou	доставка; морской транспорт
運賃	うんちん	unchin	фрахтовые ставки; судоходные расходы; плата за проезд
云々	うんぬん	unnun	и так далее
運搬	うんぱん	unpan	транспорт; перевозки
運命	うんめい	unmei	судьба
運輸	うんゆ	unyu	транспорт
運用	うんよう	unyou	использование; применение
会	え	e	понимание
重	え	e	-слойный
	えい	ei	скат (рыба)
映写	えいしゃ	eisha	проекция
英字	えいじ	eiji	английская буква (символ)
衛生	えいせい	eisei	здоровья; гигиена; санитария
映像	えいぞう	eizou	отражение; образ
英雄	えいゆう	eiyuu	герой; великий человек
液	えき	eki	жидкость 
役	えき	eki	война; кампания; сражение
閲覧	えつらん	etsuran	осмотр; чтение
獲物	えもの	emono	добыча; трофей
襟	えり	eri	воротник; шейный обод
縁	えん	en	шанс; судьба; связь; карма
塩	えん	en	соль
艶	えん	en	очаровательный; увлекательный
園	えん	en	сад 
円滑	えんかつ	enkatsu	гармония; плавность
縁側	えんがわ	engawa	веранда; крыльцо; балкон; открытый коридор
沿岸	えんがん	engan	побережье 
婉曲	えんきょく	enkyoku	косвенно; иносказательно; эвфемистически
演習	えんしゅう	enshuu	практика; упражнения
演出	えんしゅつ	enshutsu	постановка (спектакля)
演じる/演ずる	えんじる/えんずる	enjiru/ enzuru	играть (пьесу,роль) 
沿線	えんせん	ensen	вдоль железнодорожной линии
縁談	えんだん	endan	предложение (о браке)
遠方	えんぽう	enpou	долгий путь; отдаленная местность
円満	えんまん	enman	совершенство; гармония; мир; гладкость; полнота; удовлетворенность
尾	お	o	хвост; хребет
於て	おいて	oite	на; в 
甥	おい	oi	племянник
追い込む	おいこむ	oikomu	загонять
美味しい	おいしい	oishii	вкусный
追い出す	おいだす	oidasu	высылать; вытеснять
於いて	おいて	oite	на; в; на
お出でになる	おいでになる	oideninaru	быть
老いる	おいる	oiru	с возрастом; стареть
負う	おう	ou	нести; задолжать
応急	おうきゅう	oukyuu	аварийный
黄金	おうごん	ougon	золото
黄色	おうしょく	oushoku	желтый
応募	おうぼ	oubo	подписка; приложения
	おおい	ooi	эй!
大方	おおかた	ookata	почти все; большинство
大柄	おおがら	oogara	крупное телосложение; крупный узор
大げさ	おおげさ	oogesa	грандиозный; преувеличеный
大事	おおごと	oogoto	важно; ценно; серьезное дело
大ざっぱ	おおざっぱ	oozappa	грубо (не точно) 
大筋	おおすじ	oosuji	наброски; резюме
大空	おおぞら	oozora	небо; небосвод 
大幅	おおはば	oohaba	крупномасштабно; полная (вся) ширина
大水	おおみず	oomizu	наводнение
公	おおやけ	ooyake	открытый; гласный; публичный
お蔭	おかげ	okage	(ваша) поддержка,помощь
お蔭様で	おかげさまで	okagesamade	благодаря вам
可笑しい	おかしい	okashii	странно; смешно; забавно
犯す	おかす	okasu	совершить; совершать; нарушать 
侵す	おかす	okasu	вторгнуться; совершить набег; злоупотреблять; нарушать; вторгаться
お菜	おかず	okazu	гарнир для блюд из риса
臆病	おくびょう	okubyou	трусость; робость
遅らす	おくらす	okurasu	задержать; отложить
遅れ	おくれ	okure	задержка; запаздывание
起こす	おこす	okosu	поднять; разбудить 
行い	おこない	okonai	поведение; действия
厳か	おごそか	ogosoka	строгий; величественный; достойный; величественный 
傲る	おごる	ogoru	быть высокомерным; зазнаваться
長	おさ	osa	начальник; руководитель
押さえる	おさえる	osaeru	остановить; сдержать; подавить
お先に	おさきに	osakini	прежде; впереди; ранее
収まる/納まる	おさまる	osamaru	быть помещённым куда-л.; разрешаться; улаживаться
治まる	おさまる	osamaru	быть мирным; быть спокойным; стихать
お産	おさん	osan	рождение
教え	おしえ	oshie	учение; заповедь; доктрина
押し込む	おしこむ	oshikomu	отодвинуть; вытеснить
惜しむ	おしむ	oshimu	ценить; жалеть
お喋り	おしゃべり	oshaberi	болтовня; болтун 
お洒落	おしゃれ	oshare	модник; мода
押し寄せる	おしよせる	oshiyoseru	оттеснить 
お祖父さん	おじいさん	ojiisan	дед; пожилой мужчина
お邪魔します	おじゃまします	ojamashimasu	простите за беспокойство 
雄	おす	osu	самец
お世辞	おせじ	oseji	лесть; комплимент
襲う	おそう	osou	атаковать
遅くとも	おそくとも	osokutomo	не позднее
恐らく	おそらく	osoraku	возможно
恐れ	おそれ	osore	страх; ужас
恐れ入る	おそれいる	osoreiru	чувствовать себя неловко,быть сконфуженным; быть глубоко тронутым
お大事に	おだいじに	odaijini	берегите себя
煽てる	おだてる	odateru	спровоцировать; льстить
落ち込む	おちこむ	ochikomu	падать; вваливаться; западать; быть подавленным
落ち着き	おちつき	ochitsuki	спокойствие; хладнокровие
落ち葉	おちば	ochiba	опавшие листья; листопад 
落ちる	おちる	ochiru	проваливаться (на экзамене); упасть
	おっかない	okkanai	страшный; огромный
仰っしゃる	おっしゃる	ossharu	сказать; говорить; говорить; говорить
乙	おつ	otsu	2-й по рангу; второй знак
お使い	おつかい	otsukai	поручение
お手上げ	おてあげ	oteage	сдаюсь!; всё кончено!
御手洗い	おてあらい	otearai	туалет; санузел
弟	おと	oto	младший брат
落とす	おとす	otosu	падать; терять
訪れる	おとずれる	otozureru	посетить
大人しい	おとなしい	otonashii	послушный; тихий
少女	おとめ	otome	дочь; юная леди; дева; дева; девочка
お供	おとも	otomo	сопровождающий; спутник
衰える	おとろえる	otoroeru	становятся слабыми; снижаться; распадаться; чахнуть 
	おどおど	odoodo	нерешительно
脅かす/脅す	おどかす/おどす	odokasu/ odosu	угрожать; принуждать
驚き	おどろき	odoroki	удивление; изумление
同い年	おないどし	onaidoshi	того же возраста
女子	おなご	onago	женщина; девушка
お願いします	おねがいします	onegaishimasu	пожалуйста
各	おのおの	onoono	каждый; каждый; соответственно; по отдельности
自ずから	おのずから	onozukara	естественно; как само собой разумеющееся
お祖母さん	おばあさん	obaasan	бабушка; пожилая женщина 
怯える	おびえる	obieru	испугаться; бояться
夥しい	おびただしい	obitadashii	обильно; неисчислимо
帯びる	おびる	obiru	носить с собой; быть облечённым; иметь (оттенок,привкус)
覚え	おぼえ	oboe	память; чувство; опыт
御負け	おまけ	omake	скидка; приз; бонус; преувеличение
お宮	おみや	omiya	синтоистский храм
お襁褓	おむつ	omutsu	пеленки; подгузники
お目出度う	おめでとう	omedetou	поздравляем!
面	おも	omo	лицо
思い付き	おもいつき	omoitsuki	план; идея; предложение
面白い	おもしろい	omoshiroi	интересный; занимательный
玩具	おもちゃ	omocha	игрушка
重なる	おもなる	omonaru	основной; главный; важный
趣	おもむき	omomuki	значение; суть; эффект; внешний вид; вкус; изящество; очарование; изысканность
赴く	おもむく	omomuku	направляться; следовать куда-л.; становиться; делаться
重役	おもやく	omoyaku	директор
重んずる/重んずる	おもんずる/重んじる	omonzuru/ omonjiru	уважать; чтить; ценить
お休み	おやすみ	oyasumi	праздник; отпуск; отдых; спокойной ночи
お八	おやつ	oyatsu	полдник
凡そ	およそ	oyoso	грубо говоря; как правило; примерно
及び	および	oyobi	и; а также
及ぶ	およぶ	oyobu	достичь; чтобы подойти к; составить; соответствовать
織	おり	ori	переплетение; ткань
檻	おり	ori	клетка; тюремная камера
折り返す	おりかえす	orikaesu	загибать; отворачивать
織物	おりもの	orimono	текстиль; ткань
織る	おる	oru	плести
俺	おれ	ore	я (мужской вариант) 
愚か	おろか	oroka	глупо 
疎か	おろそか	orosoka	пренебрежение; халатность; небрежность
終わる	おわる	owaru	заканчивать
音色	おんいろ	oniro	тембр; тон
温和	おんわ	onwa	нежный; мягкий; умеренный
仮	か	ka	предварительный
科	か	ka	отдел
個	か	ka	счётный суффикс широкого применения; штука
下位	かい	kai	низкий ранг; подчиненный; более низкого порядка 
階	かい	kai	счётный суффикс для этажей
改悪	かいあく	kaiaku	ухудшение; изменение в худшую сторону
海運	かいうん	kaiun	морской транспорт
改革	かいかく	kaikaku	реформа; реформация; инновация
貝殻	かいがら	kaigara	оболочка
階級	かいきゅう	kaikyuu	класс; разряд 
海峡	かいきょう	kaikyou	канал
会見	かいけん	kaiken	встреча; беседа; аудиенция
介護	かいご	kaigo	уход
開催	かいさい	kaisai	устраивать; проводить
回収	かいしゅう	kaishuu	сбор; восстановление
改修	かいしゅう	kaishuu	ремонт; улучшение
怪獣	かいじゅう	kaijuu	монстр
解除	かいじょ	kaijo	аннулирование; отмена
回送	かいそう	kaisou	экспедиция
階層	かいそう	kaisou	класс; уровень; слой; иерархия
開拓	かいたく	kaitaku	рекультивация ; выращивание 
会談	かいだん	kaidan	разговор; конференция; обсуждение; интервью
改定	かいてい	kaitei	реформа
改訂	かいてい	kaitei	пересмотр
街道	かいどう	kaidou	шоссе
介入	かいにゅう	kainyuu	вмешательство
開発	かいはつ	kaihatsu	разработка; эксплуатация
海抜	かいばつ	kaibatsu	высота над уровнем моря
介抱	かいほう	kaihou	уход за больными
解剖	かいぼう	kaibou	рассечение; вскрытие
回覧	かいらん	kairan	циркуляция
海流	かいりゅう	kairyuu	морское тчение
改良	かいりょう	kairyou	улучшение; реформа
回路	かいろ	kairo	эл. цепь,контур
顧みる/省みる	かえりみる	kaerimiru	оглянуться назад; развернуться; пересмотреть
返る	かえる	kaeru	вернуться; вернуться; вернуться
顔付き	かおつき	kaotsuki	(внешние) внешность; особенности; лицо; лицо; выражение
掲げる	かかげる	kakageru	поднимать над головой$ нести высоко подняв
踵	かかと	kakato	пятка; каблук
係り	かかり	kakari	официальный; долг; ответственное лицо
課外	かがい	kagai	внеклассный
書き取り	かきとり	kakitori	диктант
書き取る	かきとる	kakitoru	записать; под диктовку; делать заметки
掻き回す	かきまわす	kakimawasu	размешивать; сбивать; грабить; нарушать
欠く	かく	kaku	не хватать; ломать; взламывать; скинуться
角	かく	kaku	угол; балка,брус
核	かく	kaku	ядро
格	かく	kaku	статус; характер; дело
佳句	かく	kaku	(великолепный) отрывок (литературного произведения
画	かく	kaku	ход
格差	かくさ	kakusa	качественное различие; неравенство
拡散	かくさん	kakusan	рассеивания; диффузия
各種	かくしゅ	kakushu	каждый вид; всякие
隔週	かくしゅう	kakushuu	раз в две недели
確信	かくしん	kakushin	убеждение; уверенность
革新	かくしん	kakushin	реформа; инновации
確定	かくてい	kakutei	решение; постановление
獲得	かくとく	kakutoku	приобретение; владение
確保	かくほ	kakuho	гарантия; страховка; безопасность
革命	かくめい	kakumei	революция
確立	かくりつ	kakuritsu	создание
賭け	かけ	kake	ставки; азартная игра
掛け	かけ	kake	кредит
駆け足	かけあし	kakeashi	бег; быстрый шаг
家計	かけい	kakei	семейные финансы
駆けっこ	かけっこ	kakekko	бег наперегонки
駆ける	かける	kakeru	бежать; скакать (о лошади)
賭ける	かける	kakeru	в пари; делать ставки; рисковать; делать ставку; чтобы играть на деньги
ヶ月	かげつ	kagetsu	номер месяца
加工	かこう	kakou	изготовление; переработка; обработка
化合	かごう	kagou	химическое соединение
嵩張る	かさばる	kasabaru	быть громоздким 
嵩む	かさむ	kasamu	накапливаться; увеличиваться
風車	かざぐるま	kazaguruma	ветряная мельница
畏まりました	かしこまりました	kashikomarimashita	слушаюсь!
華奢	かしゃ	kasha	роскошь; великолепие; тонкость; стройность
箇所	かしょ	kasho	проезд; место; точка; часть
火傷	かしょう	kashou	ожог
箇条書き	かじょうがき	kajougaki	перечисление по пунктам
噛る	かじる	kajiru	жевать; кусать; грызть 
微か	かすか	kasuka	слабый; тусклый; нечеткий
霞む	かすむ	kasumu	затуманиваться
化する	かする	kasuru	превращать(ся) во что-л.; подвергать(ся) влиянию
擦る	かする	kasuru	царапнуть; слегка задеть
火星	かせい	kasei	Марс (планета)
化石	かせき	kaseki	ископаемое; окаменение 
河川	かせん	kasen	реки
化繊	かせん	kasen	синтетическое волокно
過疎	かそ	kaso	уменьшение населения
過多	かた	kata	избыток
難い	かたい	katai	трудный
片思い	かたおもい	kataomoi	безответная любовь 
敵	かたき	kataki	враг; соперник
気質	かたぎ	katagi	дух; характер; черта; темперамент; нрав
片言	かたこと	katakoto	поверхностное знание; говорить запинаясь
片付け	かたづけ	katazuke	уборка; отделка
傾く	かたぶく	katabuku	наклониться; быть склонным к; к
傾ける	かたむける	katamukeru	наклонить; согнуть; сконцентрироваться
固める	かためる	katameru	затвердевать; заморозить; укреплять
偏る	かたよる	katayoru	быть односторонним; быть частичным; быть предвзятым
傍ら	かたわら	katawara	рядом; в то время как; неподалеку
課題	かだい	kadai	тема; тема; задача
花壇	かだん	kadan	клумба
家畜	かちく	kachiku	домашние животные; скот 
画期	かっき	kakki	эпохальный
活発	かっぱつ	kappatsu	энергичность; активность
且つ	かつ	katsu	тем не менее; и
割	かつ	katsu	разрыв; трещина
嘗て	かつて	katsute	когда-то; некогда
日付	かづけ	kazuke	дата; датировка
門	かど	kado	ворота
叶う	かなう	kanau	сбываться (о желании)
叶える	かなえる	kanaeru	исполнять (желание)
金槌	かなづち	kanazuchi	молот; молоток; обр. человек,не умеющий плавать
鉄棒	かなぼう	kanabou	железная палка; спорт. перекладина
可成	かなり	kanari	значительно; довольно
加入	かにゅう	kanyuu	присоединение; подписка; принадлежность; 
金庫	かねぐら	kanegura	сейф; хранилище; казначейство 
予言	かねごと	kanegoto	предсказание; обещание; прогнозирование
兼ねて	かねて	kanete	одновременно
下番	かばん	kaban	окончание дежурства
下品	かひん	kahin	грубый; вульгарный; низкопробый
華美	かび	kabi	великолепие; броскость
花粉	かふん	kafun	пыльца
株式	かぶしき	kabushiki	акции (компания)
気触れる	かぶれる	kabureru	реагировать на; быть под влиянием
貨幣	かへい	kahei	деньги; валюта; монеты
構え	かまえ	kamae	поза; стиль
構える	かまえる	kamaeru	устраивать; принимать положение
加味	かみ	kami	приправы; ароматизаторы
噛み切る	かみきる	kamikiru	откусить; перегрызть
過密	かみつ	kamitsu	переполненный
瓶	かめ	kame	глиняный горшок
かも知れない	かもしれない	kamoshirenai	может; возможно 
粥	かゆ	kayu	рисовая каша
痒い	かゆい	kayui	зуд 
揶揄う	からかう	karakau	дразнить; подтрунивать ; высмеивать
身体	からだ	karada	тело
体付き	からだつき	karadatsuki	телосложение; фигура
絡む	からむ	karamu	запутать; чтобы обвить
借り	かり	kari	заимствования; долг; кредит
下吏	かり	kari	ниже официального
加留多	かるた	karuta	игральные карты
涸れる	かれる	kareru	высохнуть; выбежать
過労	かろう	karou	переутомление; напряжение
辛うじて	かろうじて	karoujite	еле-еле; с большим трудом
側	かわ	kawa	сторона; часть 
可愛い	かわいい	kawaii	красивый; милый; прекрасный; обаятельный
可愛がる	かわいがる	kawaigaru	любить; быть ласковым
可哀想	かわいそう	kawaisou	жалеть
可愛らしい	かわいらしい	kawairashii	прекрасный; милый
交わす	かわす	kawasu	обмениваться (словами,приветствиями)
代わる	かわる	kawaru	заменять,замещать; сменять,приходить на смену
代わる代わる	かわるがわる	kawarugawaru	попеременно
乾	かん	kan	небо
管	かん	kan	труба; трубка
幹	かん	kan	ствол дерева
冠	かん	kan	корона; диадема; во-первых; лучше; несравненный 
観	かん	kan	смотреть; внешний вид; зрелище
館	かん	kan	дом; зал; здание; отель; гостиница; 
簡易	かんい	kani	простота; легкость
感慨	かんがい	kangai	сильные чувства; глубокие эмоции
寒気	かんき	kanki	холод; мороз
簡潔	かんけつ	kanketsu	краткость; лаконичность; простота
還元	かんげん	kangen	разрешение; восстановление; возвращение к истокам
刊行	かんこう	kankou	публикация; вопрос
慣行	かんこう	kankou	обычная практика; привычка 
勧告	かんこく	kankoku	совет; адвокат; протест; рекомендация
看護	かんご	kango	уход за больными; медсестра
漢語	かんご	kango	канго; китаизм
換算	かんさん	kansan	преобразование; изменение; обмен
監視	かんし	kanshi	наблюдение; охрана; контроль; надзор
慣習	かんしゅう	kanshuu	обычай; обыкновение
観衆	かんしゅう	kanshuu	зрители; члены аудитории
干渉	かんしょう	kanshou	вмешательство 
感触	かんしょく	kanshoku	чувство осязания; чувства; ощущения
肝心	かんじん	kanjin	важно; фундаментальное; решающее значение; жизненно важное значение
歓声	かんせい	kansei	радостные возгласы (крики); радостный голос
感染	かんせん	kansen	инфекция 
幹線	かんせん	kansen	магистраль
関税	かんぜい	kanzei	обычаи; долг; тариф
簡素	かんそ	kanso	простота; равнина
観点	かんてん	kanten	точка зрения
感度	かんど	kando	чувствительность; степень тяжести (землетрясения)
幹部	かんぶ	kanbu	управлениe; (исполнительный) персонал; руководители
勘弁	かんべん	kanben	помилование; прощение
完璧	かんぺき	kanpeki	совершенство; полнота; безупречность
感無量	かんむりょう	kanmuryou	глубокое чувство; непередаваемые ощущения; наполненный эмоциями
勧誘	かんゆう	kanyuu	приглашение; агитация; побуждение; поощрение
関与	かんよ	kanyo	участие; заинтересованность
慣用	かんよう	kanyou	обычное употребление
寛容	かんよう	kanyou	терпение; терпимость; щедрость
観覧	かんらん	kanran	просмотр
官僚	かんりょう	kanryou	бюрократ; бюрократия
慣例	かんれい	kanrei	обычай; прецедент; из конвенции
還暦	かんれき	kanreki	60-летие
貫禄	かんろく	kanroku	вес; достоинство
緩和	かんわ	kanwa	облегчение; смягчение
蓋	がい	gai	крышка; колпачок
街	がい	gai	кварталы; городские улицы
外貨	がいか	gaika	импортные товары; иностранные деньги
外観	がいかん	gaikan	внешний вид; экстерьер; фасад
外相	がいしょう	gaishou	министр иностранных дел
害する	がいする	gaisuru	ранить; наносить ущерб,вред; мешать
概説	がいせつ	gaisetsu	общее утверждение; наброски
該当	がいとう	gaitou	соответствующий; подпадающий под
街頭	がいとう	gaitou	на улице
概念	がいねん	gainen	общая идея; концепция; понятие
外来	がいらい	gairai	заграничный; иностранный
概略	がいりゃく	gairyaku	наброски; резюме; суть; вкратце
学芸	がくげい	gakugei	искусства и науки; гуманитарные науки
学士	がくし	gakushi	выпускник университета
学説	がくせつ	gakusetsu	теория
楽譜	がくふ	gakufu	нота
学歴	がくれき	gakureki	академическое образование
崖	がけ	gake	утес
雅致	がち	gachi	артистизм; хороший вкус; элегантность; изящество
	がっくり	gakkuri	сразу; резко
合唱	がっしょう	gasshou	хор; пение в хоре
	がっしり	gasshiri	твердо; прочно; жестко
合致	がっち	gacchi	соглашение; совпадение 
	がっちり	gacchiri	плотный; крепко; проницательный
月日	がっぴ	gappi	дата
合併	がっぺい	gappei	сочетание; союз; объединение; слияние; присоединение 
	がる	garu	чувствовать
側	がわ	gawa	сторона; часть
癌	がん	gan	рак
眼科	がんか	ganka	офтальмология
眼球	がんきゅう	gankyuu	глазное яблоко
眼鏡	がんきょう	gankyou	очки
頑固	がんこ	ganko	упрямство; неуступчивость
願書	がんしょ	gansho	письменное заявление или ходатайство
頑丈	がんじょう	ganjou	твердый; толстый; плотный; сильный; крепкий
岩石	がんせき	ganseki	утес
元年	がんねん	gannen	первый год (правления)
贋物	がんぶつ	ganbutsu	имитация; подделка; подлог; обман
元来	がんらい	ganrai	первоначально; в первую очередь; по существу; по логике; естественно
生	き	ki	чистый; сырой
期	き	ki	период; время
企画	きかく	kikaku	планирование; проект
規格	きかく	kikaku	стандарт; норма
着飾る	きかざる	kikazaru	наряжаться
器官	きかん	kikan	орган (тела); инструмент
季刊	きかん	kikan	ежеквартально (например журнал)
危害	きがい	kigai	травмы; вред; опасность
気兼ね	きがね	kigane	нерешительность; неуверенность в себе; чувство ограничения
気軽	きがる	kigaru	веселый; жизнерадостный; беззаботный
危機	きき	kiki	кризис
聞き取り	ききとり	kikitori	аудирование
効き目	ききめ	kikime	эффект; добродетель; эффективность; впечатление
帰京	ききょう	kikyou	возвращения в Токио
基金	ききん	kikin	фонд; 
棄権	きけん	kiken	воздерживаться от голосования; отказ от права
喜劇	きげき	kigeki	комедия
起源	きげん	kigen	происхождение; начало; повышение
機構	きこう	kikou	механизм; организация
既婚	きこん	kikon	брак
記載	きさい	kisai	упоминание; вход
気障	きざ	kiza	тщеславие; снобизм
兆(し)	きざし	kizashi	знаки; симптомы
軋む	きしむ	kishimu	скрипеть; тереть на терке
気象	きしょう	kishou	погода; климат
期日	きじつ	kijitsu	фиксированная дата; дата расчетов
記述	きじゅつ	kijutsu	описание
奇数	きすう	kisuu	нечетное число
築く	きずく	kizuku	строить; накапливать; накапливать
傷付く	きずつく	kizutsuku	быть раненым; получить травму
規制	きせい	kisei	регулирование
汽船	きせん	kisen	пароход
寄贈	きそう	kisou	преподношение
貴族	きぞく	kizoku	благородный; аристократ
鍛える	きたえる	kitaeru	ковать; прям. и перен. закалять; тренировать
来る	きたる	kitaru	прийти; приехать
気立て	きだて	kidate	характер; нрав
	きちっと	kichitto	точно 
几帳面	きちょうめん	kichoumen	пунктуальный; устойчивый
切っ掛け	きっかけ	kikkake	шанс; старт; мотив; стимул; повод
	きっかり	kikkari	точно 
喫茶	きっさ	kissa	чаепитие 
	きっちり	kicchiri	точно; плотно
屹度	きっと	kitto	конечно; несомненно; безусловно; в обязательном порядке; строго
	きっぱり	kippari	четко; ясно; отчетливо
規定	きてい	kitei	регулирование; положения
起点	きてん	kiten	отправная точка
軌道	きどう	kidou	орбита; железнодорожные пути
甲	きのえ	kinoe	1-й по рангу; первый знак китайского календаря; раковины; подъем; марка А
気配	きはい	kihai	индикация; тенденции рынка; беспокойство
規範	きはん	kihan	модель; стандарт; шаблон; норма; критерий; пример
気品	きひん	kihin	аромат
気風	きふう	kifuu	характер; черты 
起伏	きふく	kifuku	волнистость
規模	きぼ	kibo	масштаб; сфера; план; структура
気まぐれ	きまぐれ	kimagure	прихоть; каприз; прихоть; непостоянны; капризны; неровный характер
生真面目	きまじめ	kimajime	слишком серьезный человек; честность; искренность
期末	きまつ	kimatsu	конец срока
決まり悪い	きまりわるい	kimariwarui	неловкий; постыдный
決まる	きまる	kimaru	быть определенным; быть решенным 
記名	きめい	kimei	подпись
脚色	きゃくしょく	kyakushoku	инсценирование; экранизация
脚本	きゃくほん	kyakuhon	сценарий
客観	きゃっかん	kyakkan	цель
規約	きやく	kiyaku	соглашение; правила; код
救援	きゅうえん	kyuuen	облегчение; спасение; укрепление
休学	きゅうがく	kyuugaku	временное отсутствие в школе
究極	きゅうきょく	kyuukyoku	финальный; окончательный
窮屈	きゅうくつ	kyuukutsu	узкий; плотный; жесткий; ограниченный
球根	きゅうこん	kyuukon	луковица; клубень
救済	きゅうさい	kyuusai	помощь
給食	きゅうしょく	kyuushoku	обеспечение питанием (школьников,рабочих и служащих по месту учёбы или работы)
給仕	きゅうじ	kyuuji	официант; стюард; коридорный; посыльный
休戦	きゅうせん	kyuusen	перемирие
旧知	きゅうち	kyuuchi	старый друг 
宮殿	きゅうでん	kyuuden	дворец
窮乏	きゅうぼう	kyuubou	бедность
丘陵	きゅうりょう	kyuuryou	холм
共	きょう	kyou	вместе
供	きょう	kyou	предоставлять
驚異	きょうい	kyoui	сенсация; чудо
教員	きょういん	kyouin	преподавательский состав
教科	きょうか	kyouka	предмет; учебный план
協会	きょうかい	kyoukai	ассоциация; организация
共感	きょうかん	kyoukan	разделять взгляды кого-л.
共学	きょうがく	kyougaku	совместное обучение
協議	きょうぎ	kyougi	конференция; консультация; обсуждение; согласование
教訓	きょうくん	kyoukun	урок; заповедь 
境遇	きょうぐう	kyouguu	условия; среда; обстоятельства
強行	きょうこう	kyoukou	форсирование
強硬	きょうこう	kyoukou	крепкий; энергичный; несгибаемый; упорный; упрямый
凶作	きょうさく	kyousaku	неурожай
共産	きょうさん	kyousan	коммунизм
教材	きょうざい	kyouzai	учебные материалы
教習	きょうしゅう	kyoushuu	воспитание; обучения
郷愁	きょうしゅう	kyoushuu	ностальгия; тоска по родине
教職	きょうしょく	kyoushoku	профессия учителя
享受	きょうじゅ	kyouju	прием; принятие
興じる	きょうじる	kyoujiru	развлекаться; веселиться
強制	きょうせい	kyousei	обязательство; принуждение; исполнение
共存	きょうそん	kyouson	сосуществование
姉妹	きょうだい/しまい	kyoudai/shimai	сестры
協調	きょうちょう	kyouchou	сотрудничество; примирение; гармония
協定	きょうてい	kyoutei	расположение; соглашение
脅迫	きょうはく	kyouhaku	угроза; принуждение; терроризм
共鳴	きょうめい	kyoumei	резонанс; сочувствие
郷里	きょうり	kyouri	место рождения; родной город
強烈	きょうれつ	kyouretsu	сильный; интенсивный; тяжелый
共和	きょうわ	kyouwa	сотрудничество
曲	きょく	kyoku	мелодия; музыкальное произведение
局限	きょくげん	kyokugen	предел; 
極端	きょくたん	kyokutan	крайность
居住	きょじゅう	kyojuu	резиденция
拒絶	きょぜつ	kyozetsu	отказ 
拒否	きょひ	kyohi	отрицание; вето; отказ 
許容	きょよう	kyoyou	разрешение; помилование
距離	きょり	kyori	расстояние; диапазон
寄与	きよ	kiyo	вклад; обслуживание
清らか	きよらか	kiyoraka	чистый; целомудренный
気楽	きらく	kiraku	непринужденно; комфортно
煌びやか	きらびやか	kirabiyaka	великолепный; яркий; ослепительный
切り	きり	kiri	пределы; конец; границы; срок; закрытие предложение 
桐	きり	kiri	дерево павловния
切り替える	きりかえる	kirikaeru	изменять; менять; преобразовывать; возобновлять; заменять
気流	きりゅう	kiryuu	воздушное течение
奇麗	きれい	kirei	красивый
切れ目	きれめ	kireme	перерыв; пауза; разрыв; конец; прерывание
際	きわ	kiwa	край; грань; сторона
木綿	きわた	kiwata	хлопок
極めて	きわめて	kiwamete	чрезвычайно 
僅	きん	kin	немного,всего лишь (в сточетаниях)
近眼	きんがん	kingan	близорукость
緊急	きんきゅう	kinkyuu	срочный; аварийный
近々	きんきん	kinkin	близко; в скором времени
近郊	きんこう	kinkou	пригороды; окраины
均衡	きんこう	kinkou	равновесие; баланс
近視	きんし	kinshi	близорукость
禁じる	きんじる	kinjiru	запретить
禁ずる	きんずる	kinzuru	запретить; подавить
勤勉	きんべん	kinben	промышленность; трудолюбие
勤務	きんむ	kinmu	служба; долг; работа
禁物	きんもつ	kinmotsu	табу 
勤労	きんろう	kinrou	труд; напряжение
議案	ぎあん	gian	законопроект
戯曲	ぎきょく	gikyoku	игра; драма
議決	ぎけつ	giketsu	решение; постановление; резолюция
議事堂	ぎじどう	gijidou	здание парламента
犠牲	ぎせい	gisei	жертва
偽造	ぎぞう	gizou	подделка; фальсификация 
議題	ぎだい	gidai	тема для обсуждения; повестка дня
技能	ぎのう	ginou	техническое мастерство; умение; способность
逆転	ぎゃくてん	gyakuten	(внезапное) изменение; обратный ход
行	ぎょう	gyou	линия; строка; стих
業者	ぎょうしゃ	gyousha	трейдер; продавец
行政	ぎょうせい	gyousei	администрация
業績	ぎょうせき	gyouseki	достижение; производительность; результаты; работа; вклад
業務	ぎょうむ	gyoumu	бизнес; дела; обязанности; работа
玉	ぎょく	gyoku	Король (в игре сеги)
漁船	ぎょせん	gyosen	рыболовное судно
漁村	ぎょそん	gyoson	рыбацкая деревня
義理	ぎり	giri	долг; чувство долга; честь; порядочность; вежливость; долг благодарности 
疑惑	ぎわく	giwaku	опасения; недоверие; подозрительность
吟味	ぎんみ	ginmi	тестирование; изучение; тщательное исследование
区	く	ku	отделение; район; секция
食い違う	くいちがう	kuichigau	идти вразрез с; отличаться; конфликтовать 
空腹	くうふく	kuufuku	голод
区画	くかく	kukaku	разделение; раздел; отделение; граница; область; блок
区間	くかん	kukan	перегон; участок (пути)
茎	くき	kuki	стебель
区切り	くぎり	kugiri	остановка; пунктуация
潜る	くぐる	kuguru	проходить,пролезать под чем-л.; нырять; перен. благополучно миновать
種々	くさぐさ	kusagusa	разнообразие
嚏	くしゃみ	kushami	чихать
旧事	くじ	kuji	прошедшие события
籤引	くじびき	kujibiki	лотерея; жребий
擽ぐったい	くすぐったい	kusuguttai	щекотливый
草臥れる	くたびれる	kutabireru	устать; изнашиваться
下らない	くだらない	kudaranai	глупо; тривиально; ничего не стоит
件	くだん	kudan	вышеуказанный; вышеупомянутый
口ずさむ	くちずさむ	kuchizusamu	напевать
嘴	くちばし	kuchibashi	клюв
朽ちる	くちる	kuchiru	гнить
	くっきり	kukkiri	отчетливо; ясно; смело
屈折	くっせつ	kussetsu	изгиб; отступы; преломление
くっ付く	くっつく	kuttsuku	придерживаться; держаться ближе к
くっ付ける	くっつける	kuttsukeru	приложить
覆す	くつがえす	kutsugaesu	опрокинуть; расстраивать; разрушать; подрывать
諄い	くどい	kudoi	многословный; назойливый; тяжелый (на вкус)
国境	くにざかい	kunizakai	государственная граница
首飾り	くびかざり	kubikazari	ожерелье
首輪	くびわ	kubiwa	ожерелье; колье
組み合わせ	くみあわせ	kumiawase	сочетание
組み合わせる	くみあわせる	kumiawaseru	объединиться; объединить; соединиться
組み込む	くみこむ	kumikomu	полигр. вставлять,набирать дополнительно
蔵	くら	kura	склад; подвал; хранилище
苦しめる	くるしめる	kurushimeru	мучить; изводить; причинять боль
包む	くるむ	kurumu	быть охваченным; быть окутанным
呉れ呉れも	くれぐれも	kureguremo	неоднократно; искренне; искренне
呉れる	くれる	kureru	давать; делать для кого-то
玄人	くろうと	kurouto	эксперт; профессионал
黒字	くろじ	kuroji	чёрные иероглифы; бездефицитный
君主	くんしゅ	kunshu	правитель; монарх
愚痴	ぐち	guchi	жалоба; ворчанье
	ぐっと	gutto	твердо; быстро 
	ぐらい	gurai	приблизительно
群	ぐん	gun	группа; толпа; стадо
軍艦	ぐんかん	gunkan	военный корабль; линкор
群集	ぐんしゅう	gunshuu	(социальная) группа; толпа; толпа; толпа; множество
軍事	ぐんじ	gunji	военное дело
軍備	ぐんび	gunbi	вооружение; военной подготовка
軍服	ぐんぷく	gunpuku	военная форма
刑	けい	kei	казнь; приговор; наказание
頃	けい	kei	китайская мера площади
傾	けい	kei	 наклон
系	けい	kei	система; группа
経過	けいか	keika	ход; процесс; развитие
軽快	けいかい	keikai	живость,лёгкость; бодрость
警戒	けいかい	keikai	меры предосторожности
計器	けいき	keiki	метр; датчик
契機	けいき	keiki	возможность; шанс
敬具	けいぐ	keigu	с искренним уважением
軽減	けいげん	keigen	снижение
掲載	けいさい	keisai	публикация
傾斜	けいしゃ	keisha	уклон,наклон; откос; скат
形成	けいせい	keisei	формирование
形勢	けいせい	keisei	состояние; ситуация; перспективы
軽率	けいそつ	keisotsu	торопливый; опрометчивый; необдуманный
携帯	けいたい	keitai	переносной
形態	けいたい	keitai	форма; фигура
刑罰	けいばつ	keibatsu	суждение; штраф; наказание
経費	けいひ	keihi	расходы; затраты
警部	けいぶ	keibu	инспектор полиции
軽蔑	けいべつ	keibetsu	презрение; 
経歴	けいれき	keireki	личная история; карьера
経路	けいろ	keiro	маршрут; путь; курс
汚す	けがす	kegasu	опозорить; обесчестить
汚らわしい	けがらわしい	kegarawashii	грязный; несправедливый
汚れ	けがれ	kegare	нечистота; позор; гпязь
汚れる	けがれる	kegareru	испачкаться; стать грязным
獣	けだもの	kedamono	зверь; скотина
吝嗇	けち	kechi	скупость; скряга; жмот 
結核	けっかく	kekkaku	туберкулез
血管	けっかん	kekkan	кровеносный сосуд
決行	けっこう	kekkou	решительные действия
決算	けっさん	kessan	бухгалтерский баланс; расчет
決勝	けっしょう	kesshou	решение конкурсе; финал (в спорте)
結晶	けっしょう	kesshou	кристалл; кристаллизация
結成	けっせい	kessei	формирование
結束	けっそく	kessoku	союз; единство
傑	けつ	ketsu	превосходство
決意	けつい	ketsui	решение; определение
決議	けつぎ	ketsugi	разрешение; голосование 
結合	けつごう	ketsugou	сочетание; объединение
決断	けつだん	ketsudan	решение; определение
欠乏	けつぼう	ketsubou	нехватка; недостача; дефицит
蹴飛ばす	けとばす	ketobasu	прогнать; чтобы пнуть ; отказаться 
貶す	けなす	kenasu	говорить плохо о ч-л
煙たい	けむたい	kemutai	дымчатый; чувствуя неловкость
煙る	けむる	kemuru	дымиться
家来	けらい	kerai	фиксатор; свита; слуга
	けれど	keredo	но; тем не менее
圏	けん	ken	сфера; круг; диапазон
権	けん	ken	власть; право (что-то сделать)
権威	けんい	keni	власть; влияние
兼業	けんぎょう	kengyou	боковая линия; второй бизнес
権限	けんげん	kengen	власть; авторитет; юрисдикция
健在	けんざい	kenzai	быть в добром здравии; быть в хорошей форме
懸賞	けんしょう	kenshou	конкурс; премия
検事	けんじ	kenji	прокурор
健全	けんぜん	kenzen	здоровье; устойчивость 
見地	けんち	kenchi	точка зрения
賢明	けんめい	kenmei	мудрость; интеллект; благоразумие
倹約	けんやく	kenyaku	бережливость; экономия
兼用	けんよう	kenyou	многофункциональный; совместное использование; комбинация; преследующий две цели
権力	けんりょく	kenryoku	власть; авторитет; влияние
劇団	げきだん	gekidan	театральная труппа
激励	げきれい	gekirei	поощрение
月謝	げっしゃ	gessha	ежемесячная плата за обучение
	げっそり	gessori	быть в уныние; потеря веса
月賦	げっぷ	geppu	ежемесячный взнос
下痢	げり	geri	диарея
原	げん	gen	оригинальный; примитивный; первичный; фундаментальный; сырье
原形	げんけい	genkei	оригинальная форма; основная форма
現行	げんこう	genkou	теперешний; действующий; находящийся в обращении
原作	げんさく	gensaku	оригинальное произведение
原子	げんし	genshi	атом
元首	げんしゅ	genshu	правитель; государь
原書	げんしょ	gensho	оригинал документа
減少	げんしょう	genshou	уменьшение; снижение 
現場	げんじょう	genjou	фактическое место; сцена; место преступления
元素	げんそ	genso	химический элемент
原則	げんそく	gensoku	принцип; общее правило
現像	げんぞう	genzou	фото проявление
現地	げんち	genchi	фактическое место; местный
限定	げんてい	gentei	предел; ограничение
原点	げんてん	genten	происхождение (координаты); отправная точка
原典	げんてん	genten	первоисточник; источник
減点	げんてん	genten	снижение оценки; потеря баллов
原爆	げんばく	genbaku	атомная бомба
原文	げんぶん	genbun	оригинальный текст
厳密	げんみつ	genmitsu	строгий; точный; тщательный
原油	げんゆ	genyu	сырая нефть
言論	げんろん	genron	обсуждение
故	こ	ko	покойный; старый
戸	こ	ko	счетное слово для домов
児	こ	ko	ребенок; детеныш животного
巨	こ	ko	большой; 
恋する	こいする	koisuru	чтобы влюбиться в; любить
溝	こう	kou	канава
校	こう	kou	школа
好意	こうい	koui	добрая воля; милость; любезность
行為	こうい	koui	акт; поступок; поведение
行員	こういん	kouin	кассир
交易	こうえき	koueki	торговля; коммерция
公演	こうえん	kouen	публичное исполнение
後悔	こうかい	koukai	сожаление; покаяние
公開	こうかい	koukai	представление публике
航海	こうかい	koukai	парус; плавание
工学	こうがく	kougaku	машиностроение
皇居	こうきょ	koukyo	Императорский дворец
好況	こうきょう	koukyou	зажиточные условия; здоровая экономика
抗議	こうぎ	kougi	протест; возражение
鉱業	こうぎょう	kougyou	горная промышленность
興業	こうぎょう	kougyou	стимулирование промышленности
高原	こうげん	kougen	плоскогорье; плато
煌々と	こうこうと	koukouto	блестяще; ярко
考古学	こうこがく	koukogaku	археология
交互	こうご	kougo	взаимность; обратность; чередование
工作	こうさく	kousaku	работы; строительство; ремесло; маневрирование
耕作	こうさく	kousaku	выращивание; разведение
鉱山	こうざん	kouzan	шахта 
講習	こうしゅう	koushuu	курс; обучение
交渉	こうしょう	koushou	переговоры; дискуссии; подключение
高尚	こうしょう	koushou	высокий; благородный; изысканный; расширенный
行進	こうしん	koushin	марш; парад
香辛料	こうしんりょう	koushinryou	специи
口述	こうじゅつ	koujutsu	устноге заявление
控除	こうじょ	koujo	субсидии; вычет
向上	こうじょう	koujou	высота; рост; совершенствование; улучшение; прогресс
降水	こうすい	kousui	осадки
洪水	こうずい	kouzui	наводнение
公然	こうぜん	kouzen	открыто официально
抗争	こうそう	kousou	спор; сопротивление
構想	こうそう	kousou	план; сюжет; идея; концепция
拘束	こうそく	kousoku	ограничение; сдержанность
後退	こうたい	koutai	движение назад; отступление
光沢	こうたく	koutaku	блеск; блеск; глянец
公団	こうだん	koudan	государственная корпорация
好調	こうちょう	kouchou	благоприятный; перспективный; удовлетворительный; в хорошей форме
口頭	こうとう	koutou	устная речь
講読	こうどく	koudoku	чтение; перевод
購読	こうどく	koudoku	подписка (например на журнал)
購入	こうにゅう	kounyuu	приобрести; купить
公認	こうにん	kounin	официальное признание; авторизация; лицензия; аккредитация
光熱費	こうねつひ	kounetsuhi	стоимость топлива и света
荒廃	こうはい	kouhai	руины
購買	こうばい	koubai	приобрести; купить
好評	こうひょう	kouhyou	популярность; благоприятная репутация
交付	こうふ	koufu	выдача; вручение
降伏	こうふく	koufuku	капитуляция; подчинение; покорность
興奮	こうふん	koufun	волнение; возбуждение
公募	こうぼ	koubo	общественное обращение; общественный вклад
巧妙	こうみょう	koumyou	гениальный; умелый; ловкий
公用	こうよう	kouyou	публичное использование 
小売	こうり	kouri	розничная торговля
効率	こうりつ	kouritsu	эффективность
公立	こうりつ	kouritsu	общественное учреждение
小柄	こがら	kogara	небольшого роста
小切手	こぎって	kogitte	проверка
国産	こくさん	kokusan	отечественная продукция
国定	こくてい	kokutei	при поддержке государства; национальный
国土	こくど	kokudo	область
告白	こくはく	kokuhaku	исповедь; признание
国防	こくぼう	kokubou	национальная оборона
国有	こくゆう	kokuyuu	национальная ответственность
国連	こくれん	kokuren	U.N.; Организации Объединенных Наций
漕ぐ	こぐ	kogu	грести; крутить педали
焦げ茶	こげちゃ	kogecha	черный чай
個々	ここ	koko	индивидуальный; один за другим
箇箇	ここ	koko	индивидуальный; отдельный
心地	ここち	kokochi	чувство; ощущение; настроение
心得	こころえ	kokoroe	знания; информация
心掛け	こころがけ	kokorogake	готовность; намерение; цель
心掛ける	こころがける	kokorogakeru	иметь в виду; нацелиться
志	こころざし	kokorozashi	воля; намерение; мотив
志す	こころざす	kokorozasu	планировать; быть намеренным; стремиться к; нацеливаться
心強い	こころづよい	kokorozuyoi	спокойный; внушающий уверенность; ободряющий
心細い	こころぼそい	kokorobosoi	беспомощный; одинокий; безнадежный; бесперспективный 
試み	こころみ	kokoromi	испытание; эксперимент
試みる	こころみる	kokoromiru	пробовать; проверять
快い	こころよい	kokoroyoi	приятно
凝らす	こごらす	kogorasu	замораживать; застывать
凝る	こごる	kogoru	застывать; затвердевать
拵える	こしらえる	koshiraeru	сделать; чтобы изготовить
孤児	こじ	koji	сирота
拗れる	こじれる	kojireru	выходить из строя; портиться; запутываться; 
故人	こじん	kojin	покойный; усопший
梢	こずえ	kozue	верхушка дерева
個性	こせい	kosei	индивидуальность; личность
戸籍	こせき	koseki	книга посемейной записи; регистрационная книга
小銭	こぜに	kozeni	мелочь; разменная монета
固体	こたい	kotai	твердое вещество
答え	こたえ	kotae	ответ 
火燵	こたつ	kotatsu	стол с нагревателем; котацу
古代	こだい	kodai	древние времена
	こだわる	kodawaru	препятствовать,сопротивляться; уделять слишком много внимания пустякам
誇張	こちょう	kochou	преувеличение
滑稽	こっけい	kokkei	комизм; юмор; шутка
国交	こっこう	kokkou	дипломатические отношения
骨董品	こっとうひん	kottouhin	антикварная вещь
骨	こつ	kotsu	умение; мастерство
固定	こてい	kotei	фиксация
事柄	ことがら	kotogara	независимо от того; вещь; дело; обстоятельство
悉く	ことごとく	kotogotoku	в целом; полностью
言伝	ことづて	kotozute	предание; сказание
殊に	ことに	kotoni	особенно; прежде всего
事によると	ことによると	kotoniyoruto	в зависимости от обстоятельств
孤独	こどく	kodoku	изоляция; одиночество
粉々	こなごな	konagona	на очень маленькие части
此の	この	kono	это
この間	このあいだ	konoaida	на днях; в последнее время
この頃	このごろ	konogoro	недавно
好ましい	このましい	konomashii	хороший; симпатичный; желательный
個別	こべつ	kobetsu	частный случай
零す	こぼす	kobosu	проливать
零れる	こぼれる	koboreru	переполненяться; проливать
細やか	こまやか	komayaka	дружелюбный
混む	こむ	komu	быть переполненным
込める	こめる	komeru	включить; ввести в
篭る	こもる	komoru	уединиться; быть заключенным в; быть душным
固有	こゆう	koyuu	свойственный; присущий
雇用	こよう	koyou	занятости (долгосрочная); прокат
暦	こよみ	koyomi	календарь; альманах
堪える	こらえる	koraeru	терпеть; выносить; выдерживать; годиться,быть пригодным
孤立	こりつ	koritsu	изоляция; беспомощность; одиночество
懲りる	こりる	koriru	научиться на горьком опыте
此れ	これ	kore	это
此れ等	これら	korera	эти
魂	こん	kon	душа; дух
根気	こんき	konki	терпение; настойчивость; энергия
根拠	こんきょ	konkyo	основа; фундамент
混血	こんけつ	konketsu	смешание расы; смешанный брако
昆虫	こんちゅう	konchuu	насекомое; 
根底	こんてい	kontei	корень; основа; фундамент
混同	こんどう	kondou	спутанность сознания; смешивание; слияние
根本	こんぽん	konpon	происхождения; источником; фундамент; корень; основа; принцип
御	ご	go	уважительный префикс
語彙	ごい	goi	лексика; глоссарий
濠	ごう	gou	ров
業	ごう	gou	карма; действия; совершенные в прошлой жизни
号	ごう	gou	число; номер
合意	ごうい	goui	соглашение; согласие; взаимопонимание
合議	ごうぎ	gougi	консультация; конференция
強気	ごうぎ	gougi	большой; великий
合成	ごうせい	gousei	синтез; состав; синтез; соединение
護衛	ごえい	goei	охранник 
語句	ごく	goku	слова; фразы
極楽	ごくらく	gokuraku	рай
ご苦労様	ごくろうさま	gokurousama	спасибо вам большое за ваш ....
語源	ごげん	gogen	корень слова; этимология
誤差	ごさ	gosa	ошибка
ご座います	ございます	gozaimasu	быть (вежливо); существовать
ご馳走	ごちそう	gochisou	праздник; угощение
ご馳走さま	ごちそうさま	gochisousama	угощение
毎	ごと	goto	каждый 
碁盤	ごばん	goban	доска для игры в "го"
誤魔化す	ごまかす	gomakasu	обмануть; фальсифицировать; искажать
御免ください	ごめんください	gomenkudasai	извините; можно войти?
御免なさい	ごめんなさい	gomennasai	прошу прощения; извините
御覧なさい	ごらんなさい	gorannasai	(вежливо) смотреть; (вежливо) пытаться сделать
佐	さ	sa	помощь
再	さい	sai	повторно; опять же
差異	さい	sai	разница; несоответствие
歳	さい	sai	(возраст) лет
再会	さいかい	saikai	еще одна встреча; воссоединение
災害	さいがい	saigai	бедствие; катастрофа; беда
細菌	さいきん	saikin	палочка; бактерия; микроб
細工	さいく	saiku	работа; мастерство; тактика; трюк
採掘	さいくつ	saikutsu	добыча
採決	さいけつ	saiketsu	голосование
再建	さいけん	saiken	восстановление; реконструкция
再現	さいげん	saigen	появление; возвращение; возрождение
採算	さいさん	saisan	прибыль
採集	さいしゅう	saishuu	сбор
再生	さいせい	saisei	регенерация; реанимация; возвращение к жизни; возрождение
最善	さいぜん	saizen	самое лучшее
採択	さいたく	saitaku	выбор 
再発	さいはつ	saihatsu	возвращение; рецидив; повторение
栽培	さいばい	saibai	выращивание
細胞	さいぼう	saibou	клетка (биология)
採用	さいよう	saiyou	использование; принятие
遮る	さえぎる	saegiru	прерывать; перехватывать; мешать
囀る	さえずる	saezuru	чирикать; щебетать; петь
冴える	さえる	saeru	быть ясным; быть холодным; приобретать умение
竿	さお	sao	стержень; шест; древко
栄える	さかえる	sakaeru	процветать; 
杯	さかずき	sakazuki	чашечка для сакэ; рюмка; бокал
逆立ち	さかだち	sakadachi	стойка на руках; на голове
逆上る	さかのぼる	sakanoboru	вернуться; пойти вверх по течению
盛る	さかる	sakaru	процветать 
差額	さがく	sagaku	баланс; разница 
下がる	さがる	sagaru	свисать; стихать; уйти в отставку; упасть; сделать шаг назад
一昨昨日	さきおととい	sakiototoi	позапозавчера 
先に	さきに	sakini	прежде; раньше; чем; вперед; за пределы; ранее; в последнее время
詐欺	さぎ	sagi	мошенничество
作	さく	saku	работа; урожай
策	さく	saku	план; политика
柵	さく	saku	забор; частокол
削減	さくげん	sakugen	сокращение; свертывание
錯誤	さくご	sakugo	ошибка
作戦	さくせん	sakusen	военные или военно-морские операции; тактика; стратегия
作物	さくぶつ	sakubutsu	литературное произведение
叫び	さけび	sakebi	крик 
裂ける	さける	sakeru	разделять; рвать; лопаться
捧げる	ささげる	sasageru	поднять; дать; предложить; посвятить; пожертвовать 
差し掛かる	さしかかる	sashikakaru	приближаться к; подойти
指図	さしず	sashizu	инструкция; мандат
差し出す	さしだす	sashidasu	представлять (на рассмотрение); предъявлять; подавать
差し支える	さしつかえる	sashitsukaeru	вмешиваться; мешать; чтобы стать затруднение
差し引く	さしひく	sashihiku	вычитать
些事	さじ	saji	мелочь
授ける	さずける	sazukeru	предоставлять; нагрждать; присваивать
嘸	さぞ	sazo	конечно же; без сомнения; 
定まる	さだまる	sadamaru	быть определённым,решённым; стабилизироваться,
定める	さだめる	sadameru	устанавливать; определять; назначать
錯覚	さっかく	sakkaku	оптическая иллюзия; галлюцинация
早急	さっきゅう	sakkyuu	срочный
察する	さっする	sassuru	предполагать; представлять себе
	さっと	satto	быстро; внезапно
冊	さつ	satsu	счетное слово для книг
殺人	さつじん	satsujin	убийство
偖	さて	sate	союз (а) теперь; итак
悟る	さとる	satoru	воспринимать; понимать; различать
裁く	さばく	sabaku	судить
錆び	さび	sabi	ржавчина
左程	さほど	sahodo	(не) очень; (не) много
様	さま	sama	г-н или г-жа; манера 
三味線	さみせん	samisen	трехструнный японский инструмент; сямисэн
然も	しかも	shikamo	кроме того; впридачу; и что; более того; также
作用	さよう	sayou	действие; операция; эффект; функция
左様なら	さようなら	sayounara	прощай
拐う	さらう	sarau	утащить; похитить 
爽やか	さわやか	sawayaka	свежий; освежающий; бодрящий; свободный
障る	さわる	sawaru	мешать; наносить вред,ущерб 
酸	さん	san	кислота
酸化	さんか	sanka	окисление
山岳	さんがく	sangaku	горы
産休	さんきゅう	sankyuu	отпуск по беременности
桟橋	さんきょう	sankyou	причал; мост; причал; пирс
参議院	さんぎいん	sangiin	палата советников
産後	さんご	sango	после родов
産出	さんしゅつ	sanshutsu	продукция
参照	さんしょう	sanshou	ссылка; консультация
参上	さんじょう	sanjou	посещение; визит
賛成	さんせい	sansei	одобрение; согласие; поддержка
賛美	さんび	sanbi	похвала; обожание; прославление
産婦人科	さんふじんか	sanfujinka	акушерство и гинекология
産物	さんぶつ	sanbutsu	продукт; результат 
山腹	さんぷく	sanpuku	горный склон; склон горы
山脈	さんみゃく	sanmyaku	горный хребет
財	ざい	zai	финансы
財源	ざいげん	zaigen	источник средств,ресурсов ,финансов
在庫	ざいこ	zaiko	запас; фонд
財政	ざいせい	zaisei	экономика; финансовые дела
座談会	ざだんかい	zadankai	симпозиум; круглый стол
雑貨	ざっか	zakka	смешанные товары
雑	ざつ	zatsu	грубый; сырой
雑談	ざつだん	zatsudan	болтовня
雑木	ざつぼく	zatsuboku	различные деревья; смешанный лес
座標	ざひょう	zahyou	координаты
残金	ざんきん	zankin	остаток (денег); бухг. сальдо
残酷	ざんこく	zankoku	жестокость
残高	ざんだか	zandaka	баланс; остаток
次	し	shi	порядок; последовательность 
仕上がり	しあがり	shiagari	завершение; окончание; результат
仕上げ	しあげ	shiage	завершение; окончание; отделка; последние штрихи
仕上げる	しあげる	shiageru	закончить; завершить
明々後日	しあさって	shiasatte	послепослезавтра
飼育	しいく	shiiku	разведение
強いて	しいて	shiite	силой
強いる	しいる	shiiru	заставить; принудить 
仕入れる	しいれる	shiireru	принимать (на хранение); заготовлять; хранить; восполнять запас
	しいんと	shiinto	тихо
歯科	しか	shika	лечение зубов
資格	しかく	shikaku	квалификация; требования; возможности
視覚	しかく	shikaku	зрение; видение
仕掛け	しかけ	shikake	устройство; трюк; механизм; гаджет; (уменьшенный) масштаб 
仕掛ける	しかける	shikakeru	начать; заложить (мины); установить (ловушки); вести (войну); бросить вызов
然し	しかし	shikashi	однако; но
然しながら	しかしながら	shikashinagara	тем не менее; однако
而も	しかも	shikamo	более того; кроме того; тем не менее; и в то же
市街	しがい	shigai	городские районы; улицы; город
指揮	しき	shiki	команда; направление
色彩	しきさい	shikisai	цвет; оттенок 
式場	しきじょう	shikijou	церемониальный зал; место церемонии (например; брак)
為来り	しきたり	shikitari	таможенный
頻りに	しきりに	shikirini	часто; неоднократно; не переставая; с нетерпением
仕切る	しきる	shikiru	разделить; разделить; расквитаться 
資金	しきん	shikin	фонды; капитал
施行	しぎょう	shigyou	выполнение; соблюдения; проведение
	しくじる	shikujiru	провалиться
仕組み	しくみ	shikumi	разработка; план; сюжет; приспособление; конструкция
死刑	しけい	shikei	смертная казнь; смертный приговор
湿気る	しける	shikeru	быть влажным
思考	しこう	shikou	мысль
志向	しこう	shikou	намерение; цель
嗜好	しこう	shikou	вкус; симпатии; предпочтение
視察	しさつ	shisatsu	осмотр; наблюдение
資産	しさん	shisan	собственность; состояние; активы
刺繍	ししゅう	shishuu	вышивка
支持	しじ	shiji	поддержка; обслуживание
指示	しじ	shiji	 инструкция; направления
雫	しずく	shizuku	капля (воды)
沈める	しずめる	shizumeru	тонуть; погружаться
施設	しせつ	shisetsu	оборудование; сооружения; объекты
子息	しそく	shisoku	сын
慕う	したう	shitau	тосковать по ч-л.; обожать; любить нежно
従って	したがって	shitagatte	поэтому; соответственно; в соответствии с
下心	したごころ	shitagokoro	тайное намерение
親しむ	したしむ	shitashimu	быть близким с; подружиться
下調べ	したしらべ	shitashirabe	предварительное следствие; подготовка
下地	したじ	shitaji	основа; фундамент; наклон; способности; элементарное знание; заземление в; под вторичные; лопата
認める	したためる	shitatameru	признавать; одобрять; разрешать
仕立てる	したてる	shitateru	адаптировать; делать; подготавливать; обучать 
下取り	したどり	shitadori	покупать новую модель в обмен на старую (с доплатой)
下火	したび	shitabi	затухать; идти на убыль (о пожаре и т.п.)
失格	しっかく	shikkaku	дисквалификация; устранение; неспособность 
確り	しっかり	shikkari	твердо; жестко; надежно; устойчиво
質素	しっそ	shisso	простота; скромность; бережливость
失調	しっちょう	shicchou	отсутствие гармонии
嫉妬	しっと	shitto	ревность
尻尾	しっぽ	shippo	хвост (животного)
室	しつ	shitsu	номер
質疑	しつぎ	shitsugi	вопрос
躾	しつけ	shitsuke	обучение; воспитание 
仕付ける	しつける	shitsukeru	смётывать; сшивать на скорую руку; сажать (рассаду)
指摘	してき	shiteki	указание; идентификация
視点	してん	shiten	мнение; точка зрения 
萎びる	しなびる	shinabiru	слабеть; исчезать
嫋か	しなやか	shinayaka	эластичный; гибкий; упругий
屎尿	しにょう	shinyou	экскременты; неочищенные сточные воды 
凌ぐ	しのぐ	shinogu	терпеть; выносить
始発	しはつ	shihatsu	первый поезд
芝	しば	shiba	газон; торф
屡	しばしば	shibashiba	часто; снова и снова
暫く	しばらく	shibaraku	некоторое время
痺れる	しびれる	shibireru	затекать; неметь 
渋い	しぶい	shibui	со вкусом (одежда); прохладно; терпкий; угрюмый; горький (вкус)
私物	しぶつ	shibutsu	частная собственность; личные вещи
	しぶとい	shibutoi	цепкий; упрямый
司法	しほう	shihou	отправление правосудия
脂肪	しぼう	shibou	жир 
志望	しぼう	shibou	желание; стремление; честолюбие
萎む	しぼむ	shibomu	вянуть; сохнуть; блёкнуть
仕舞	しまい	shimai	конец; прекращение
仕舞う	しまう	shimau	делать до конца; полностью сделать что-то 
	しまった	shimatta	черт побери!
始末	しまつ	shimatsu	обстоятельства,детали чего-л.; возможность справиться
泌み泌み	しみじみ	shimijimi	остро; глубоко; сердечно
染みる	しみる	shimiru	проникать
使命	しめい	shimei	миссия; поручение; назначение
締め切り	しめきり	shimekiri	не закрытие; отсечение; конец; срок; закрытое; не вход
僕	しもべ	shimobe	слуга 
社交	しゃこう	shakou	социальная жизнь
謝絶	しゃぜつ	shazetsu	отказ
社宅	しゃたく	shataku	жилой дом для работников компании 
吃逆	しゃっくり	shakkuri	икота
喋る	しゃべる	shaberu	говорить; общаться; болтать
斜面	しゃめん	shamen	склон; наклонная поверхность 
洒落	しゃらく	sharaku	откровенно говоря; с открытым сердцем
洒落る	しゃれる	shareru	шутить; играть на словах; одеваться стильно
視野	しや	shiya	поле зрения; перспективы
種	しゅ	shu	 разнообразие; вид; сорт
衆	しゅう	shuu	массы; люди
周	しゅう	shuu	схема; круг; окружность; окрестности; Чжоу (династия)
収益	しゅうえき	shuueki	прибыль; доходы
修学	しゅうがく	shuugaku	изучение
周期	しゅうき	shuuki	цикл; период
衆議院	しゅうぎいん	shuugiin	нижняя палата; палата представителей
就業	しゅうぎょう	shuugyou	работа; начало работы
修行	しゅうぎょう	shuugyou	изучение; обучение; подготовка; дисциплина
集計	しゅうけい	shuukei	суммирование; итог
襲撃	しゅうげき	shuugeki	атака; заряд; рейд
収支	しゅうし	shuushi	приход и расход
終始	しゅうし	shuushi	начало и конец; от начала до конца
修士	しゅうし	shuushi	степень магистра
収集	しゅうしゅう	shuushuu	сбор; накопление
修飾	しゅうしょく	shuushoku	орнамент; украшения
終日	しゅうじつ	shuujitsu	весь день
執着	しゅうじゃく	shuujaku	привязанность
収容	しゅうよう	shuuyou	размещение; прием; размещение; обеспечение жильем; словарная запись
修了	しゅうりょう	shuuryou	завершение (курса)
守衛	しゅえい	shuei	охранник; сторож
主演	しゅえん	shuen	главная роль
主観	しゅかん	shukan	субъективность 
祝賀	しゅくが	shukuga	празднование
宿命	しゅくめい	shukumei	судьба; предопределение
主権	しゅけん	shuken	суверенитет; верховенство; власть
手芸	しゅげい	shugei	ремесло
主催	しゅさい	shusai	организация; спонсорство
取材	しゅざい	shuzai	выбор материала
趣旨	しゅし	shushi	объект; значение
主食	しゅしょく	shushoku	основные продукты питания
主人公	しゅじんこう	shujinkou	главный герой; глава семьи
主体	しゅたい	shutai	тема; основная составляющая
主題	しゅだい	shudai	тема; мотив
出血	しゅっけつ	shukketsu	кровотечение 
出産	しゅっさん	shussan	рождение ребенка; производство (товаров)
出社	しゅっしゃ	shussha	прибытие (в стране на работе и т.д.)
出生	しゅっしょう	shusshou	рождение
出世	しゅっせ	shusse	продвижение по службе; успешная карьера; повышение
出費	しゅっぴ	shuppi	расходы; выплаты
出品	しゅっぴん	shuppin	выставка; показ
出演	しゅつえん	shutsuen	выход (на сцену,арену и т.п.); выступление
出題	しゅつだい	shutsudai	предложив вопрос
出動	しゅつどう	shutsudou	выступать (в поход); выходить (в море); вводиться в действие 
主導	しゅどう	shudou	основное руководство
主任	しゅにん	shunin	ответственное лицо 
首脳	しゅのう	shunou	голова; мозги
守備	しゅび	shubi	защита
手法	しゅほう	shuhou	техника
私有	しゆう	shiyuu	частная собственность
諸	しょ	sho	разнообразный; многие; несколько
背負う	しょう	shou	быть обремененным; проводить на спине или плече
象	しょう	shou	явление
症	しょう	shou	болезнь
傷	しょう	shou	рана; травма; боль; рана; ушиб; царапина; шрам; слабое место
商	しょう	shou	частное
消去	しょうきょ	shoukyo	устранение; удаление 
衝撃	しょうげき	shougeki	столкновение; удар; толчок; импульс; шок; потрясение
証言	しょうげん	shougen	свидетельство; показания
証拠	しょうこ	shouko	доказательство
消耗	しょうこう	shoukou	истощение; потребление
照合	しょうごう	shougou	сортировка; сравнение
詳細	しょうさい	shousai	детали; данные
昇進	しょうしん	shoushin	продвижение
少数	しょうすう	shousuu	меньшинство; малое количество
称する	しょうする	shousuru	притворяться; симулировать 
消息	しょうそく	shousoku	известия; сведения; данные
承諾	しょうだく	shoudaku	согласие; соглашение
象徴	しょうちょう	shouchou	символ
小児科	しょうにか	shounika	педиатрия
証人	しょうにん	shounin	свидетель
照明	しょうめい	shoumei	освещение
勝利	しょうり	shouri	победа; триумф; завоевание; успех; победа
奨励	しょうれい	shourei	поощрение; продвижение по службе
職員	しょくいん	shokuin	сотрудник персонала
植民地	しょくみんち	shokuminchi	колония
職務	しょくむ	shokumu	профессиональные обязанности
諸君	しょくん	shokun	Господа!; Дамы !
所在	しょざい	shozai	местонахождение
所々	しょしょ	shosho	тут и там; некоторые части (чего-то)
所持	しょじ	shoji	владение; владелец
所属	しょぞく	shozoku	быть прикрепленным к; принадлежать
処置	しょち	shochi	лечение
	しょっちゅう	shocchuu	всегда; постоянно
所定	しょてい	shotei	фиксированный; предписанный
所得	しょとく	shotoku	доход; прибыль
初版	しょはん	shohan	первое издание
処罰	しょばつ	shobatsu	наказание
書評	しょひょう	shohyou	книжное обозрение
処分	しょぶん	shobun	распоряжение; наказание
庶民	しょみん	shomin	массы; простые люди
庶務	しょむ	shomu	общие вопросы
私用	しよう	shiyou	личное пользование; частный бизнес
仕様	しよう	shiyou	способ; метод; ресурс; средство; (техническая) спецификация
使用人	しようにん	shiyounin	сотрудник; служащий
調べ	しらべ	shirabe	подготовка; исследование; осмотр
知り合い	しりあい	shiriai	знакомство
退く	しりぞく	shirizoku	отступать
退ける	しりぞける	shirizokeru	отразить; отогнать
記す	しるす	shirusu	отметить; записать
指令	しれい	shirei	приказы; распоряжения; директивы
代	しろ	shiro	цена; материалы; замена
皺	しわ	shiwa	морщины; складки
新	しん	shin	новый
進化	しんか	shinka	эволюция; прогресс
殿	しんがり	shingari	сзади; задний блок охранник
審議	しんぎ	shingi	обсуждение
進行	しんこう	shinkou	продвигать
新興	しんこう	shinkou	новый; вновь возникший; восходящий
振興	しんこう	shinkou	продвижение по службе; поощрение
申告	しんこく	shinkoku	доклад; рапорт; подача сведений
新婚	しんこん	shinkon	молодожены
審査	しんさ	shinsa	осмотр; обследование; исследование
紳士	しんし	shinshi	джентльмен
進出	しんしゅつ	shinshutsu	заранее; шаг вперед
信者	しんじゃ	shinja	верующий; преданный 
真珠	しんじゅ	shinju	жемчуг
心中	しんじゅう	shinjuu	двойное самоубийство 
心情	しんじょう	shinjou	склад ума
新人	しんじん	shinjin	новичок
神聖	しんせい	shinsei	святость; священность; достоинство
親善	しんぜん	shinzen	дружба
真相	しんそう	shinsou	правда; реальная ситуация
新築	しんちく	shinchiku	новое здание; новое строительство
進呈	しんてい	shintei	презентация
進展	しんてん	shinten	прогресс; развитие
神殿	しんでん	shinden	храм; святое место
進度	しんど	shindo	прогресс
振動	しんどう	shindou	колебания; вибрации
新入生	しんにゅうせい	shinnyuusei	первокурсник 
信任	しんにん	shinnin	доверие; уверенность
審判	しんばん	shinban	судейство; постановление; судья 
神秘	しんぴ	shinpi	тайна
辛抱	しんぼう	shinbou	терпение; выносливость
真理	しんり	shinri	правда
侵略	しんりゃく	shinryaku	агрессия; вторжение; рейд
診療	しんりょう	shinryou	обследование и лечение; диагностика
進路	しんろ	shinro	путь; маршрут
自覚	じかく	jikaku	застенчивый
地方	じかた	jikata	область; населенный пункт; район
自我	じが	jiga	я; эго
磁気	じき	jiki	магнетизм
磁器	じき	jiki	фарфор 
事業	じぎょう	jigyou	проект; предприятие; бизнес; промышленность; операции
地形	じぎょう	jigyou	местность; географические особенности; рельеф
軸	じく	jiku	ось; стержень; вал
自己	じこ	jiko	Я; сам
事項	じこう	jikou	материя; вещь; факты
時刻表	じこくひょう	jikokuhyou	таблица; диаграмма; график 
地獄	じごく	jigoku	ад
時差	じさ	jisa	разница во времени
自在	じざい	jizai	свободно; по своему желанию
自主	じしゅ	jishu	независимость; автономия
自首	じしゅ	jishu	явка преступника с повинной
辞職	じしょく	jishoku	отставка
自信	じしん	jishin	самоуверенность
事前	じぜん	jizen	до; заранее; заранее
自尊心	じそんしん	jisonshin	самоуважение; тщеславие
持続	じぞく	jizoku	продолжение
字体	じたい	jitai	шрифт; буквы
辞退	じたい	jitai	отказ
	じっくり	jikkuri	сознательно; тщательно
実質	じっしつ	jisshitsu	вещество; сущность
実践	じっせん	jissen	практика; на практике
実態	じったい	jittai	действительное положение; существующая обстановка
実費	じっぴ	jippi	фактический расход; себестоимость
十分	じっぷん	jippun	10 минут
実	じつ	jitsu	правда; реальность; искренность; сущность
実業家	じつぎょうか	jitsugyouka	промышленник; предприниматель
実情	じつじょう	jitsujou	реальное состояние; фактические обстоятельства; фактическое положение дел
自転	じてん	jiten	вращение
自動詞	じどうし	jidoushi	непереходный глагол (без прямого объекта)
地主	じぬし	jinushi	арендодатель
耳鼻科	じびか	jibika	отоларингология
地元	じもと	jimoto	местный
弱	じゃく	jaku	слабость
若干	じゃっかん	jakkan	некоторые; немногие; количество
砂利	じゃり	jari	гравий; балласт; галька
じゃん拳	じゃんけん	janken	игра камень-ножницы-бумага 
住	じゅう	juu	жилья; гостиная
従業員	じゅうぎょういん	juugyouin	сотрудник; работник
従事	じゅうじ	juuji	заниматься чем-л.
充実	じゅうじつ	juujitsu	полнота; завершение; совершенство; субстанциональность; обогащение
十字路	じゅうじろ	juujiro	перекресток
絨毯	じゅうたん	juutan	ковер
柔軟	じゅうなん	juunan	гибкий 
重複	じゅうふく	juufuku	дублирование; повторение; перекрытие; резервирование; восстановление
重宝	じゅうほう	juuhou	бесценное сокровище; удобство; полезность
従来	じゅうらい	juurai	раньше; в прошлом; до сих пор
塾	じゅく	juku	курсы (подготовительные,повышения квалификации и т.п.)
樹木	じゅもく	jumoku	деревья и кустарники 
樹立	じゅりつ	juritsu	установить; создать
準急	じゅんきゅう	junkyuu	местный экспресс (поезд медленнее экспресса)
準じる	じゅんじる	junjiru	следовать; соответствовать 
準ずる	じゅんずる	junzuru	применять соответственно; быть соответствующим; быть соразмерным; 
助	じょ	jo	помощь; спасение; помощник
情	じょう	jou	чувства; эмоции; страсть
畳	じょう	jou	татами; соломенный мат
尉	じょう	jou	младший офицер
嬢	じょう	jou	молодая женщина
状	じょう	jou	форма
上位	じょうい	joui	превосходить ; более высокого порядка 
上演	じょうえん	jouen	исполнение (например музыки)
城下	じょうか	jouka	земля рядом с замком
乗客	じょうかく	joukaku	пассажир
上空	じょうくう	joukuu	небо; небеса; высотные небо
上司	じょうし	joushi	власть; босс
情緒	じょうしょ	jousho	эмоции; чувства
上昇	じょうしょう	joushou	скалолазание
情勢	じょうせい	jousei	положение вещей; состояние; ситуация
情熱	じょうねつ	jounetsu	страсть; энтузиазм; рвение
丈夫	じょうふ	joufu	герой; джентльмен; воин; мужественный человек; надежность; сила; твердость
譲歩	じょうほ	jouho	уступка; примирение; компромисс
条約	じょうやく	jouyaku	договор; пакт
上陸	じょうりく	jouriku	посадка; высадка
蒸留	じょうりゅう	jouryuu	перегонка
除外	じょがい	jogai	исключение
助言	じょげん	jogen	совет; предложение
徐行	じょこう	jokou	тихий ход
女史	じょし	joshi	госпожа... (после фамилий писательниц,женщин-учёных и т.п.)
助詞	じょし	joshi	частица (грам.)
助動詞	じょどうし	jodoushi	вспомогательный глагол
自立	じりつ	jiritsu	независимость; уверенность в себе
人	じん	jin	человек 
人格	じんかく	jinkaku	личность; характер; индивидуальность
人材	じんざい	jinzai	способный человек
迅速	じんそく	jinsoku	быстро
人体	じんたい	jintai	человеческое тело
人民	じんみん	jinmin	люди; общество
人目	じんもく	jinmoku	проблеск; общественный взгляд
水気	すいき	suiki	влага; сырость; пар; отек
水源	すいげん	suigen	исток реки 
推進	すいしん	suishin	двигатель; движущая сила
水洗	すいせん	suisen	промывка
吹奏	すいそう	suisou	играть на духовых инструментах
推測	すいそく	suisoku	предположеие; гипотеза
水田	すいでん	suiden	заливное рисовое поле
推理	すいり	suiri	рассуждение; вывод; тайна или детективный жанр 
数詞	すうし	suushi	цифра
崇拝	すうはい	suuhai	поклонение; обожание; восхищение; культ
据え付ける	すえつける	suetsukeru	установить; оборудовать; 
据える	すえる	sueru	ставить,устанавливать; усаживать кого-л.; назначать на должность
清々しい	すがすがしい	sugasugashii	свежий; освежающий
過ぎ	すぎ	sugi	прошлое; после
救い	すくい	sukui	помощь; спасение
掬う	すくう	sukuu	чтобы выкопать; чтобы разливать
少なくとも	すくなくとも	sukunakutomo	по крайней мере
直ぐ	すぐ	sugu	немедленно; в ближайшее время; честно говоря; прямо
健やか	すこやか	sukoyaka	энергичный; здоровый
濯ぐ	すすぐ	susugu	полоскать; промывать
進み	すすみ	susumi	прогресс
勧め	すすめ	susume	рекомендация; совет; поддержка
裾	すそ	suso	манжеты; подол; подножие горы
廃れる	すたれる	sutareru	выходить из употребления; устареть; вымирать; выходить из моды
酸っぱい	すっぱい	suppai	кислый
素敵	すてき	suteki	прекрасный; красивый; отличный; фантастический; великолепный 
即ち	すなわち	sunawachi	то есть; а именно; т.е.
	すばしこい	subashikoi	ловкий; умный; быстрый
素早い	すばやい	subayai	быстрый; проворный
済ます	すます	sumasu	до конца; чтобы покончить с этим; для урегулирования; заключить; чтобы окупить
澄ます	すます	sumasu	очистить; сделать ясным; быть невозмутимым; смотреть 
済まない	すまない	sumanai	жаль (фраза)
済みません	すみません	sumimasen	жаль; извините
天皇	すめらぎ	sumeragi	Император Японии
刷り	すり	suri	печать
剃る	する	suru	брить
擦れ違い	すれちがい	surechigai	случайная встреча
すれ違う	すれちがう	surechigau	пройти мимо друг друга; не согласиться; пропустить друг друга
擦れる	すれる	sureru	тереть; растирать 
	すんなり	sunnari	пройти без каких-либо возражений; тонкий; стройный
図々しい	ずうずうしい	zuuzuushii	наглый; бесстыдный
	ずばり	zubari	решительно; решительно; раз и навсегда; безоговорочно; честно говоря
ずぶ濡れ	ずぶぬれ	zubunure	пропитанный; мокрый
	ずらっと	zuratto	в строке 
	ずるずる	zuruzuru	скользкий; попасть в неприятную ситуацию
	ずれ	zure	разрыв; соскальзывание
	ずれる	zureru	скользить; соскальзывать
制	せい	sei	система; организация; законы; регулирование; контроль; подавление; сдержанность
製	せい	sei	производство; изготовление
生育	せいいく	seiiku	рост; развитие; размножение
成果	せいか	seika	результаты; плоды
正解	せいかい	seikai	правильно; не так ли; правильное решение
正規	せいき	seiki	 правовой; формальный; установленный; законный
正義	せいぎ	seigi	справедливость; право 
生計	せいけい	seikei	средства к существованию 
政権	せいけん	seiken	администрация; политическая власть
精巧	せいこう	seikou	сложный; деликатный; изысканный
制裁	せいさい	seisai	сдержанность; санкции; наказание
政策	せいさく	seisaku	политические меры; политика
清算	せいさん	seisan	ликвидация 
星座	せいざ	seiza	созвездие
生死	せいし	seishi	жизнь и смерть
静止	せいし	seishi	тишина; покой
青春	せいしゅん	seishun	молодость; весна жизни 
聖書	せいしょ	seisho	Библия
誠実	せいじつ	seijitsu	искренний; честный; верный
成熟	せいじゅく	seijuku	зрелость
清純	せいじゅん	seijun	чистота; невинность
正常	せいじょう	seijou	нормализация обстановки; нормальность 
制する	せいする	seisuru	контролировать; чтобы взять верх над
整然	せいぜん	seizen	аккуратно; систематично
盛装	せいそう	seisou	парадный костюм; наряд
盛大	せいだい	seidai	большой; процветающий; великолепный
清濁	せいだく	seidaku	добро и зло; чистота и грязь
制定	せいてい	seitei	принятие; создание
静的	せいてき	seiteki	статический
製鉄	せいてつ	seitetsu	производство железа
晴天	せいてん	seiten	хорошая погода
正当	せいとう	seitou	просто; оправданно; справедливо; разумно; законно 
成年	せいねん	seinen	совершеннолетний
制服	せいふく	seifuku	форма
征服	せいふく	seifuku	завоевание; покорение; преодоление
製法	せいほう	seihou	способ изготовления; рецепт; формула
精密	せいみつ	seimitsu	выверенный; точный; подробный
声明	せいめい	seimei	декларация; заявление; провозглашение
姓名	せいめい	seimei	полное имя
制約	せいやく	seiyaku	ограничение; состояние
生理	せいり	seiri	физиология; менструация
勢力	せいりょく	seiryoku	влияние; власть; мощь; сила; энергия
整列	せいれつ	seiretsu	стоять в ряд; образовывать линию
急かす	せかす	sekasu	торопить
伜	せがれ	segare	(мой) сын
責務	せきむ	sekimu	обязанность; обязательство
世辞	せじ	seji	лесть; комплимент
世帯	せたい	setai	семья
世代	せだい	sedai	поколение; мир; возраст
切開	せっかい	sekkai	разрез; вскрытие
接触	せっしょく	sesshoku	прикосновение
設置	せっち	secchi	создание; учреждение
折衷	せっちゅう	secchuu	компромисс; смешивание; эклектика
設定	せってい	settei	создание 
説得	せっとく	settoku	убеждение
節	せつ	setsu	узел; раздел; повод; время
切実	せつじつ	setsujitsu	настоятельный; насущный; неотложный
接続詞	せつぞくし	setsuzokushi	соединение
切ない	せつない	setsunai	тяжёлый; мучительный
設立	せつりつ	setsuritsu	создание; фундамент; учреждение
攻め	せめ	seme	нападение; преступление
世論	せろん	seron	общественное мнение
仙	せん	sen	отшельник; мастер
前	せん	sen	до
繊維	せんい	seni	волокна; текстиль
選挙	せんきょ	senkyo	выборы
宣教	せんきょう	senkyou	религиозная миссии
宣言	せんげん	sengen	декларация; провозглашение; объявление
先行	せんこう	senkou	предыдущий
選考	せんこう	senkou	отбор; селекция
戦災	せんさい	sensai	повреждение от войны
専修	せんしゅう	senshuu	специализация
戦術	せんじゅつ	senjutsu	тактика
潜水	せんすい	sensui	дайвинг
先先月	せんせんげつ	sensengetsu	позапрошлый месяц
先先週	せんせんしゅう	sensenshuu	позапрошлая неделя
先代	せんだい	sendai	предыдущее поколение
先だって	せんだって	sendatte	недавно; на днях
先着	せんちゃく	senchaku	первый заезд
先天的	せんてんてき	sententeki	априори; врожденный; присущий 
戦闘	せんとう	sentou	бой; борьба; 
潜入	せんにゅう	sennyuu	вторжение
船舶	せんぱく	senpaku	корабль
専用	せんよう	senyou	специальный; для личного пользования
占領	せんりょう	senryou	оккупация; захват 
戦力	せんりょく	senryoku	военный потенциал
税務署	ぜいむしょ	zeimusho	налоговая служба
是正	ぜせい	zesei	коррекция; пересмотр
絶版	ぜっぱん	zeppan	прекращение печати
絶望	ぜつぼう	zetsubou	отчаяние; безнадежность
是非とも	ぜひとも	zehitomo	всеми средствами 
膳	ぜん	zen	(японский) стол; поднос; еда
禅	ぜん	zen	Дзен (буддизм)
全快	ぜんかい	zenkai	полное восстановление здоровья
全盛	ぜんせい	zensei	процветание
前提	ぜんてい	zentei	преамбула; помещение; причина; условие
前途	ぜんと	zento	перспективы; прогноз 
全滅	ぜんめつ	zenmetsu	полное уничтожение
善良	ぜんりょう	zenryou	доброта; добродетель
前例	ぜんれい	zenrei	прецедент
僧	そう	sou	монах; священник
沿う	そう	sou	следовать
添う	そう	sou	сопровождать; выдавать замуж; соблюдать
総	そう	sou	целый; весь; полный
相応	そうおう	souou	пригодность; подходящесть
総会	そうかい	soukai	общее собрание
創刊	そうかん	soukan	начало выпуска (например газеты); первый номер
送金	そうきん	soukin	перевод денег; отпрака денег
走行	そうこう	soukou	пробег (автомобиля и т.п.)
総合	そうごう	sougou	синтез; интеграция; соединение
捜査	そうさ	sousa	поиск (особенно в уголовных расследованиях); расследование
捜索	そうさく	sousaku	поиск 
然うして	そうして	soushite	и; как и
装飾	そうしょく	soushoku	орнамент
操縦	そうじゅう	soujuu	менеджмент; управление; контроль
創造	そうぞう	souzou	создание
壮大	そうだい	soudai	великолепный; великий; величественный
騒動	そうどう	soudou	борьба; бунт; мятеж
遭難	そうなん	sounan	катастрофа; крушение; авария
相場	そうば	souba	рыночная цена; спекуляция; оценка
装備	そうび	soubi	оборудование
創立	そうりつ	souritsu	создание; основатель; организация
添える	そえる	soeru	добавление; сопровождение; подражать
即座に	そくざに	sokuzani	немедленно; сразу же
促進	そくしん	sokushin	продвижение по службе; ускорение; поощрение; содействие 
即する	そくする	sokusuru	соответствовать; согласиться с; быть адаптированным; основываться на
束縛	そくばく	sokubaku	сдержанность; ограничение; связывание
側面	そくめん	sokumen	сторона; фланг 
其処	そこ	soko	здесь
其処で	そこで	sokode	так (союз); соответственно; сейчас; то 
損なう	そこなう	sokonau	вредить; ранить; повреждать
其処ら	そこら	sokora	везде; где-то; примерно там
素材	そざい	sozai	сырье; материалы
阻止	そし	soshi	блокировка; сдерживание
然して	そして	soshite	и
訴訟	そしょう	soshou	судебный процесс 
育ち	そだち	sodachi	разведение; рост
措置	そち	sochi	мера; шаг
其方	そちら	sochira	там; другой
素っ気ない	そっけない	sokkenai	резкий; грубый; холодный
率直	そっちょく	socchoku	откровенность; искренность 
外方	そっぽ	soppo	прост. другая сторона (направление)
備え付ける	そなえつける	sonaetsukeru	обеспечить; предоставить; оборудовать 
備わる	そなわる	sonawaru	быть оборудованым; владеть; быть среди; быть одним из; обладать
園	その	sono	сад; парк; плантации
その上	そのうえ	sonoue	кроме того
その内	そのうち	sonouchi	в конце концов; рано или поздно; из ранее упомянутых
その為	そのため	sonotame	таким образом; по этой причине
その外	そのほか	sonohoka	кроме того; в дополнение
其の儘	そのまま	sonomama	без изменений; как сейчас
聳える	そびえる	sobieru	выситься; возвышаться
素朴	そぼく	soboku	простота; безыскусность; наивность
染まる	そまる	somaru	красить
背く	そむく	somuku	противоречить; не подчиняться; идти против
染める	そめる	someru	окрасить
逸らす	そらす	sorasu	отвернуться; предотвратить
反り	そり	sori	кривизна; искривление 
其れ	それ	sore	это 
其れから	それから	sorekara	а затем; после чего
各々	それぞれ	sorezore	каждый; каждый; либо; соответственно; по отдельности
其れで	それで	sorede	и; в этой связи; из-за этого
其れでは	それでは	soredeha	в этой ситуации; а потом ...
其れでも	それでも	soredemo	но (еще); и все же; тем не менее; даже в этом случае; несмотря на
其れ共	それとも	soretomo	или; иначе
其れに	それに	soreni	кроме того; кроме того
其れ程	それほど	sorehodo	до такой степени; степени
其れ故	それゆえ	soreyue	поэтому; по этой причине; так
揃い	そろい	soroi	комплектность; комплект; посещаемость (лекций и т.п.)
徐々	そろそろ	sorosoro	постепенно; неуклонно; спокойно; не спеша; в ближайшее время
損失	そんしつ	sonshitsu	потеря
存続	そんぞく	sonzoku	продолжительность; продолжение
沿い	ぞい	zoi	вместе
像	ぞう	zou	статуя; изображение; рисунок; фотография; портрет
増強	ぞうきょう	zoukyou	увеличить; усилить 
蔵相	ぞうしょう	zoushou	министр финансов
増進	ぞうしん	zoushin	содействие; увеличение
	ぞんざい	zonzai	грубо; небрежно; неряшливо
他意	たい	tai	злая воля; злоба; другое намерение; тайная цель
対応	たいおう	taiou	взаимодействие; переписка; справиться с; имеем дело с
退化	たいか	taika	дегенерация; регресс
体格	たいかく	taikaku	телосложение; конституция
大概	たいがい	taigai	в общем; в основном
退学	たいがく	taigaku	бросить школу
大金	たいきん	taikin	большая стоимость
待遇	たいぐう	taiguu	лечение; прием
対決	たいけつ	taiketsu	противостояние; противостояние
体験	たいけん	taiken	личный опыт
対抗	たいこう	taikou	оппозиция; антагонизм
対して	たいして	taishite	для; в отношении; в
大衆	たいしゅう	taishuu	общественность
対処	たいしょ	taisho	браться за что-л.; справляться с чем-л.
退職	たいしょく	taishoku	выход на пенсию
退治	たいじ	taiji	истребление
態勢	たいせい	taisei	отношение; условия; препараты
対談	たいだん	taidan	обсуждение; диалог; разговор
対等	たいとう	taitou	эквивалент
滞納	たいのう	tainou	задержка (внесения налога и т.п.); неуплата в срок
対比	たいひ	taihi	контраст; сравнение
大部	たいぶ	taibu	наиболее; большая часть
対辺	たいへん	taihen	противоположная сторона
待望	たいぼう	taibou	ожидания
怠慢	たいまん	taiman	халатность; промедление; беспечность
対面	たいめん	taimen	интервью; встреча
対立	たいりつ	tairitsu	противостояние; оппозиция; антагонизм
体力	たいりょく	tairyoku	физическая сила
対話	たいわ	taiwa	интерактивный; взаимодействие; беседа; диалог
耐える	たえる	taeru	вынести; выддержать
絶える	たえる	taeru	вымирать; иссякать; прекращаться
堪える	たえる	taeru	вынести; выстоять; вытерпеть; смириться с; противостоять; сопротивляться; быть пригодными для 
高	たか	taka	количество; размер; объем; количество; сумма денег
高まる	たかまる	takamaru	расти; возрастать; увеличиваться
焚火	たきび	takibi	(открытый) огонь; костер
沢山	たくさん	takusan	многие; много
逞しい	たくましい	takumashii	дородный; сильные; крепкие
巧み	たくみ	takumi	мастерство; ловкость
類	たぐい	tagui	своего рода
丈	たけ	take	высота; рост; длина; мера; все (один имеет)
足し算	たしざん	tashizan	дополнение
多数決	たすうけつ	tasuuketsu	принцип большинства
助け	たすけ	tasuke	помощь
携わる	たずさわる	tazusawaru	участвовать
漂う	ただよう	tadayou	плавать; висеть в воздухе
館	たち	tachi	особняк; небольшой замок
立方	たちかた	tachikata	танцоры
忽ち	たちまち	tachimachi	сразу; в один миг; вдруг; все сразу
立ち寄る	たちよる	tachiyoru	зайти; заглянуть
達者	たっしゃ	tassha	здоровый; крепкий
達成	たっせい	tassei	достижение
	たった	tatta	только; просто; не более
尊い/貴い	たっとい	tattoi	драгоценный; ценный; бесценный; благородный; возвышенный; священное
尊ぶ	たっとぶ	tattobu	ценить; почитать
絶つ	たつ	tatsu	разорвать; отрезать; подавить; воздерживаться (от)
盾	たて	tate	щит
建前	たてまえ	tatemae	лицо; официальная позиция; общественная позиция или отношение 
奉る	たてまつる	tatematsuru	предложить; представить; почтить; сделать с уважением
例え/仮令	たとえ	tatoe	например; даже если; тем не менее; хотя
他動詞	たどうし	tadoushi	переходный глагол (с прямым объектом)
辿り着く	たどりつく	tadoritsuku	наконец добраться до цели (после долгого и трудного пути)
辿る	たどる	tadoru	следовать (по дороге); следить за
掌	たなごころ	tanagokoro	ладонь
楽しむ	たのしむ	tanoshimu	веселиться
頼み	たのみ	tanomi	запрос; одолжение
煙草	たばこ	tabako	табак; сигареты
度々	たびたび	tabitabi	часто; неоднократно
他方	たほう	tahou	другое направление; с другой стороны
多忙	たぼう	tabou	сильная занятость
給う	たまう	tamau	получать; предоставлять
偶に	たまに	tamani	иногда 
堪らない	たまらない	tamaranai	невыносимо 
溜まり	たまり	tamari	место сбора; зал ожидания; стоянка
賜る	たまわる	tamawaru	предоставить; даровать
例	ためし	tameshi	пример; случай
躊躇う	ためらう	tamerau	медлить
保つ	たもつ	tamotsu	хранить; удерживать; поддерживать 
容易い	たやすい	tayasui	легко; просто; свет
多様	たよう	tayou	разнообразие 
弛み	たるみ	tarumi	слабина; ослабление 
弛む	たるむ	tarumu	ослаблять 
誰	たれ	tare	кто?
垂れる	たれる	tareru	свешивать(ся); капать
歎	たん	tan	горе; вздох; плач
反	たん	tan	рулон ткани (ок. 10 ярдов); 0,245 акров; 300 цубо
単一	たんいつ	tanitsu	один; простой; единственным; индивидуальный
短歌	たんか	tanka	танка; 31 - слоговой японский стих
担架	たんか	tanka	носилки; мусор
短気	たんき	tanki	вспыльчивость
探検	たんけん	tanken	разведка; экспедиция
短縮	たんしゅく	tanshuku	сокращение; аббревиатура 
箪笥	たんす	tansu	комод
炭素	たんそ	tanso	углерод 
短大	たんだい	tandai	двухгодичный колледж 
単調	たんちょう	tanchou	однообразие; монотонность
単独	たんどく	tandoku	единственный; независимый; один 
短波	たんぱ	tanpa	короткая радиоволна
蛋白質	たんぱくしつ	tanpakushitsu	белок
第	だい	dai	префикс порядковых числительных
第一	だいいち	daiichi	первый; в первую очередь; № 1
大胆	だいたん	daitan	смелый; дерзкий
台無し	だいなし	dainashi	свести на нет; уничтожить; угробить
大便	だいべん	daiben	кал; испражнения
代弁	だいべん	daiben	оплата по доверенности
台本	だいほん	daihon	сценарий
代用	だいよう	daiyou	замена
打開	だかい	dakai	выход из положения; разрешение вопроса
妥協	だきょう	dakyou	компромисс 
丈	だけ	dake	только; просто 
妥結	だけつ	daketsu	соглашение
打撃	だげき	dageki	удар; шок; повреждение
駄作	ださく	dasaku	плохая работа 
脱出	だっしゅつ	dasshutsu	побег
脱する	だっする	dassuru	освобождаться от чего-л.; спасаться от чего-л; избегать
脱退	だったい	dattai	отделение
	だぶだぶ	dabudabu	свободно; вяло
騙す	だます	damasu	обмануть 
	だらけ	darake	прост. суф. полный чего-л.; кишащий чем-л.
怠い	だるい	darui	вялый; чувствовать себя тяжелым; томный
壇	だん	dan	платформа; подиум; трибуна 
団結	だんけつ	danketsu	единство; союз; сочетание
断言	だんげん	dangen	декларация; утверждение
断然	だんぜん	danzen	твердо; абсолютно; безусловно; 
段々	だんだん	dandan	постепенно; постепенно
旦那	だんな	danna	хозяин; муж 
断面	だんめん	danmen	поперечное сечение
弾力	だんりょく	danryoku	эластичность; гибкость
治安	ちあん	chian	общественный порядок
近付く	ちかづく	chikazuku	подойти; приблизиться
違える	ちがえる	chigaeru	меняться
契る	ちぎる	chigiru	обещать; клясться
畜産	ちくさん	chikusan	животноводство
畜生	ちくしょう	chikushou	зверь; скотина 
蓄積	ちくせき	chikuseki	накопление
知性	ちせい	chisei	интеллект
乳	ちち	chichi	молоко; грудь; вымя
父母	ちちはは	chichihaha	родители
縮まる	ちぢまる	chijimaru	укоротить; сокращаться
窒息	ちっそく	chissoku	удушение
些とも	ちっとも	chittomo	когда-нибудь; при случае
秩序	ちつじょ	chitsujo	порядок; регулярность; система; способ
知的	ちてき	chiteki	интеллектуальный
著	ちゃく	chaku	счетное слово для одежды; прибытие в ..
着手	ちゃくしゅ	chakushu	посадка; запуск
着色	ちゃくしょく	chakushoku	расцветка
着席	ちゃくせき	chakuseki	место
着目	ちゃくもく	chakumoku	внимание
着陸	ちゃくりく	chakuriku	приземление; посадка
着工	ちゃっこう	chakkou	начало работы
茶の間	ちゃのま	chanoma	гостиная (в японскои стиле)
茶の湯	ちゃのゆ	chanoyu	чайная церемония
	ちやほや	chiyahoya	баловать; носиться с 
昼間	ちゅうかん	chuukan	день; в течение дня
宙返り	ちゅうがえり	chuugaeri	сальто 
中継	ちゅうけい	chuukei	реле; трансляция
忠告	ちゅうこく	chuukoku	совет; предупреждение
中指	ちゅうし	chuushi	средний палец
中傷	ちゅうしょう	chuushou	клевета; диффамация
忠実	ちゅうじつ	chuujitsu	верность; верность
中枢	ちゅうすう	chuusuu	центр; стержень; опора; ядро; костяк; столб
抽選	ちゅうせん	chuusen	лотерея
中断	ちゅうだん	chuudan	прерывание; перерыв
中腹	ちゅうっぱら	chuuppara	раздражаться; обижаться
中毒	ちゅうどく	chuudoku	отравление
仲人	ちゅうにん	chuunin	сват; сваха
昼飯	ちゅうはん	chuuhan	обед
中立	ちゅうりつ	chuuritsu	нейтральность
中和	ちゅうわ	chuuwa	нейтрализовать; противодействовать
腸	ちょう	chou	кишки; кишечник
蝶	ちょう	chou	бабочка
超	ちょう	chou	супер-; ультра-; гипер-
庁	ちょう	chou	правительственное ведомство; учреждение
調印	ちょういん	chouin	подпись; знак; герметизация
聴覚	ちょうかく	choukaku	слух
長官	ちょうかん	choukan	начальник
聴講	ちょうこう	choukou	посещаемость лекций 
徴収	ちょうしゅう	choushuu	сбор
聴診器	ちょうしんき	choushinki	стетоскоп
挑戦	ちょうせん	chousen	вызов (на поединок,соревнование и т.п.) 
長大	ちょうだい	choudai	очень долго; большая длина
調停	ちょうてい	choutei	арбитраж; посредничество
恰度	ちょうど	choudo	просто; не так ли; точно
長編	ちょうへん	chouhen	сокр. роман; полнометражный фильм
丁目	ちょうめ	choume	район города; городской квартал 
調理	ちょうり	chouri	кулинария
調和	ちょうわ	chouwa	гармония
	ちょくちょく	chokuchoku	часто; время от времени
直面	ちょくめん	chokumen	конфронтация
著書	ちょしょ	chosho	литературное произведение; книга
貯蓄	ちょちく	chochiku	экономия
直感	ちょっかん	chokkan	интуиция
一寸	ちょっと	chotto	немножко,чуточку; на минутку
著名	ちょめい	chomei	хорошо известно; отметил; отмечается
	ちらっと	chiratto	на первый взгляд; случайно
塵取り	ちりとり	chiritori	совок для мусора
治療	ちりょう	chiryou	лечение
賃金	ちんぎん	chingin	заработная плата
沈殿	ちんでん	chinden	отложение; осаждение
沈没	ちんぼつ	chinbotsu	 затопление
沈黙	ちんもく	chinmoku	тишина; скрытность
陳列	ちんれつ	chinretsu	выставка; шоу
追及	ついきゅう	tsuikyuu	догнать; нагнать; добиваться
追跡	ついせき	tsuiseki	погоня
次いで	ついで	tsuide	далее; впоследствии
追放	ついほう	tsuihou	изгнание 
費やす	ついやす	tsuiyasu	посвятить; тратить
墜落	ついらく	tsuiraku	падение (самолёта и т.п.)
通	つう	tsuu	счетное слово для писем
痛感	つうかん	tsuukan	чувствовать остро
通常	つうじょう	tsuujou	вообще; как правило; 
痛切	つうせつ	tsuusetsu	острый
杖	つえ	tsue	тростник
遣い	つかい	tsukai	простая задача
使い道	つかいみち	tsukaimichi	использование
仕える	つかえる	tsukaeru	служить; работать на
司る	つかさどる	tsukasadoru	править; управлять
束の間	つかのま	tsukanoma	момент; краткое время
付き	つき	tsuki	удача; везение; в связи с тем
付き合う	つきあう	tsukiau	поддерживать знакомство отношения
月並み	つきなみ	tsukinami	каждый месяц 
尽きる	つきる	tsukiru	иссякать; исчерпываться; истекать (о времени)
継ぎ目	つぎめ	tsugime	точка соединения
吐く	つく	tsuku	дышать; сказать (ложь); рвать; извергать
尽くす	つくす	tsukusu	заканчиваться; исчерпываться; прийти к концу
作り	つくり	tsukuri	макияж; нарезанная сырая рыба
造り	つくり	tsukuri	изготовление; конструкция; телосложение
造る	つくる	tsukuru	сделать; создать; разработать; писать; сочинять; построить; выдумать 
繕う	つくろう	tsukurou	исправить; починить; залатать; штопать; привести в порядок 
接ぐ	つぐ	tsugu	присоединиться; собрать воедино; установить
継ぐ	つぐ	tsugu	быть преемником; наследовать; чинить; 
付け加える	つけくわえる	tsukekuwaeru	положить одну вещь на другую
告げる	つげる	tsugeru	сообщить
辻褄	つじつま	tsujitsuma	согласованность и последовательность действий
途中	つちゅう	tsuchuu	на пути; по пути
突っ張る	つっぱる	tsupparu	упираться; подпирать
筒	つつ	tsutsu	трубы; трубки
銃	つつ	tsutsu	пистолет
突く	つつく	tsutsuku	засунуть; ударить; атаковать; подтолкнуть
慎む	つつしむ	tsutsushimu	быть осторожным; быть целомудренным,сдержанным
伝言	つてごと	tsutegoto	устное послание; слух; слово
勤まる	つとまる	tsutomaru	подходить; годиться; справляться с работой
勤め先	つとめさき	tsutomesaki	место работы
努めて	つとめて	tsutomete	работай!
津波	つなみ	tsunami	цунами; приливная волна
抓る	つねる	tsuneru	ущипнуть
募る	つのる	tsunoru	вербовать; объявлять набор; усиливаться; принимать острый характер
唾	つば	tsuba	слюна 
呟く	つぶやく	tsubuyaku	бормотать 
瞑る	つぶる	tsuburu	закрыть глаза
壷	つぼ	tsubo	горшок; кувшин; сосуд
蕾	つぼみ	tsubomi	бутон; цветок бутон
躓く	つまずく	tsumazuku	наткнуться; к поездке
摘む	つまむ	tsumamu	споткнуться; оступиться; сделать неверный шаг
詰らない	つまらない	tsumaranai	незначительный; скучный; пустяковый
詰まり	つまり	tsumari	в двух словах; другими словами; то есть; в конечном счете; в конце концов; блокада; начинка 
積もり	つもり	tsumori	намерение; план
露	つゆ	tsuyu	роса
強まる	つよまる	tsuyomaru	усиливаться
強める	つよめる	tsuyomeru	укреплять; усиливать
連なる	つらなる	tsuranaru	расширить; растянуться; встать в один ряд
貫く	つらぬく	tsuranuku	пройти
連ねる	つらねる	tsuraneru	перейти по ссылке; присоединиться; ставить в ряд; образовывать цепь
釣り	つり	tsuri	рыбалка; 
吊り革	つりかわ	tsurikawa	ремень
釣鐘	つりがね	tsurigane	висячий (храмовый) колокол
吊るす	つるす	tsurusu	повесить
手当て	てあて	teate	пособие; компенсация; лечение; медицинское обслуживание
体	てい	tei	внешний вид; воздух; состояние; форма
提供	ていきょう	teikyou	предоставление; предложение
定義	ていぎ	teigi	определение
提携	ていけい	teikei	соглашение; связка; блок
体裁	ていさい	teisai	порядочность; стиль; форма; внешний вид; формат
梯子	ていし	teishi	лестница
定食	ていしょく	teishoku	комплексный обед
提示	ていじ	teiji	презентация; выставка; цитата
訂正	ていせい	teisei	коррекция; пересмотр
停滞	ていたい	teitai	застой; путы; заторы; удержание; накопление; попадая в задолженности
邸宅	ていたく	teitaku	особняк; резиденция
定年	ていねん	teinen	пенсионный возраст
堤防	ていぼう	teibou	банк; водослив
手遅れ	ておくれ	teokure	слишком поздно; запоздалое лечение
手数	てかず	tekazu	количество ходов; проблемы
手掛かり	てがかり	tegakari	контакт; тропа; запах; на руках; держать руку
手掛ける	てがける	tegakeru	в обращении; управлять; работать; чтобы поднять; ухаживать; иметь опыт работы с
手軽	てがる	tegaru	легкий; простой; неформальный; навскидку; дешевый
的	てき	teki	фамильярно-пренебрежительный суффикс лица 
適応	てきおう	tekiou	адаптация; размещение; соответствие
適宜	てきぎ	tekigi	пригодность
適性	てきせい	tekisei	способность
手際	てぎわ	tegiwa	искусство; мастерство; ловкость; исполнение; представление
手順	てじゅん	tejun	процесс; процедура; протокол
手錠	てじょう	tejou	наручники; кандалы
手近	てぢか	tejika	рядом; под рукой; знакомы
	てっきり	tekkiri	безусловно; конечно; вне всякого сомнения; 
鉄鋼	てっこう	tekkou	железо и сталь
徹する	てっする	tessuru	осознаваться; проникнуть; посвятить себя; верить в; пройти; сделать тщательно
鉄片	てっぺん	teppen	металолом
手配	てはい	tehai	подготовка; приготовления; установление распорядка
手筈	てはず	tehazu	расположение; план; программа
手引き	てびき	tebiki	руководство; внедрение
手本	てほん	tehon	модель; шаблон
手回し	てまわし	temawashi	подготовка; приготовления; сборы
手元	てもと	temoto	палочки для еды и тарелочки для накладывания
照り返す	てりかえす	terikaesu	отразить
手分け	てわけ	tewake	разделение труда
店	てん	ten	магазин; учреждение
点火	てんか	tenka	зажигание; освещение
転回	てんかい	tenkai	революция; переворот
転換	てんかん	tenkan	поворот к чему-л.; переход к чему-л.; перевод на что-л.; конверсия
転居	てんきょ	tenkyo	изменение места жительства
転勤	てんきん	tenkin	передача; передача
点検	てんけん	tenken	осмотр; обследование; проверка
転校	てんこう	tenkou	переход в другую школу
天国	てんごく	tengoku	рай
天才	てんさい	tensai	гений; природный дар
天災	てんさい	tensai	стихийное бедствие; катастрофа
展示	てんじ	tenji	выставка; показ
天井	てんじょう	tenjou	потолок
転じる	てんじる	tenjiru	в свою очередь; переложить; чтобы изменить; чтобы отвлечь
点線	てんせん	tensen	пунктирная линия; перфорированная линия
天体	てんたい	tentai	небесное тело
転転/転々	てんてん	tenten	переходить из рук в руки; переходить с места на место
	てんで	tende	(не) вообще; в целом; полностью
転任	てんにん	tennin	перевод на работу в другое учреждение (на другую должность)
展望	てんぼう	tenbou	вид; мировоззрение; перспектива
転落	てんらく	tenraku	падение; деградация; 
出合う/出くわす	であう/でくわす	deau/ dekuwasu	встретиться случайно; произойти; столкнуться; провести свидание 
出入り口	でいりぐち	deiriguchi	выход и вход
	でかい	dekai	огромный
出来物	できもの	dekimono	нарыв; волдырь; опухоль; превосходно сделанная вещь; выдающийся человек
出切る	できる	dekiru	закончиться; не остаться; целиком выйти
出鱈目	でたらめ	detarame	ерунда; бессмыслица; случайный; бессистемный 
出直し	でなおし	denaoshi	регулировка
田園	でんえん	denen	поля и сады; деревня; сельская местность
電源	でんげん	dengen	источник электроэнергии
伝説	でんせつ	densetsu	традиция; легенда; фольклор
電線	でんせん	densen	электрическая линия
伝達	でんたつ	dentatsu	передача (информации); распространение (звука и т.п.)
伝来	でんらい	denrai	передача по наследству; из поколения в поколение,наследование
	と	to	если (союз) 
問い合わせる	といあわせる	toiawaseru	запрашивать; искать информацию
問屋	といや	toiya	оптовый склад
問う	とう	tou	спросить; на вопрос; обвинять; не придавать значения
棟	とう	tou	место; раздел; здание
等	とう	tou	и т.д.; и тому подобное
陶器	とうき	touki	керамика
等級	とうきゅう	toukyuu	класс 
討議	とうぎ	tougi	дебаты; обсуждение
登校	とうこう	toukou	посещаемость (в школе)
統合	とうごう	tougou	интеграция; объединение; синтез
倒産	とうさん	tousan	банкротство; разориться; обанкротиться
投資	とうし	toushi	инвестиции
統治	とうじ	touji	управление; правление
統制	とうせい	tousei	регулирование; контроль
当選	とうせん	tousen	избрание
逃走	とうそう	tousou	бегство; дезертирство; побег
統率	とうそつ	tousotsu	командование; руководство
到達	とうたつ	toutatsu	достижение; прибытие
到底	とうてい	toutei	с отриц. совершенно,абсолютно (о невозможности и т.п.)
丁々	とうとう	toutou	звон (мечей,топора); вырубка деревьев
投入	とうにゅう	tounyuu	вкладывание; вбрасывание; внесение
当人	とうにん	tounin	данное лицо; этот человек
逃亡	とうぼう	toubou	побег
冬眠	とうみん	toumin	спячка
登録	とうろく	touroku	регистрация; вход; запись
討論	とうろん	touron	дебаты; обсуждение
遠ざかる	とおざかる	toozakaru	удаляться; отдаляться; держаться на расстоянии
遠回り	とおまわり	toomawari	объезд; окольный путь
通りかかる	とおりかかる	toorikakaru	пройти мимо
兎角	とかく	tokaku	часто; обычно; обыкновенно
咎める	とがめる	togameru	укорять; порицать; придираться; воспаляться
時折	ときおり	tokiori	иногда
跡切れる	とぎれる	togireru	сделать паузу; прервать
説く	とく	toku	объяснить; выступить; чтобы проповедовать; чтобы убедить
特技	とくぎ	tokugi	специальные навыки
特産	とくさん	tokusan	специальный продукт
特集	とくしゅう	tokushuu	специальный выпуск 
得点	とくてん	tokuten	полученные отметки; спорт. очки,счет (га най счет ноль-ноль)
特派	とくは	tokuha	специальная командировка
特有	とくゆう	tokuyuu	характерный; свойственный
研ぐ	とぐ	togu	точить; шлифовать; рыскать; точить; полировать; мыть (рис)
刺	とげ	toge	шип; осколок; заноза
遂げる	とげる	togeru	выполнить; достичь; осуществить
床	とこ	toko	кровать; постель; ниша 
所が	ところが	tokoroga	однако; в то время как; даже если
所で	ところで	tokorode	кстати; даже если; несмотря ни на что
年頃	としごろ	toshigoro	возраст,возрастные рамки; брачный возраст
年寄り	としより	toshiyori	старики; в возрасте
戸締り	とじまり	tojimari	запирание дверей
途上	とじょう	tojou	в пути; на полпути
綴じる	とじる	tojiru	связывать; переплетать
途絶える	とだえる	todaeru	остановить; прекратить; прийти к концу
特許	とっきょ	tokkyo	специальное разрешение; патент
疾っくに	とっくに	tokkuni	давно
特権	とっけん	tokken	привилегия; специальное право
咄嗟	とっさ	tossa	момент; мгновенно
取っ手	とって	totte	ручка; рукоятка
突破	とっぱ	toppa	пробив; прорыв; проникновение
突如	とつじょ	totsujo	вдруг; внезапно
迚も	とても	totemo	очень; чрезвычайно
整える	ととのえる	totonoeru	привести в порядок; подготовиться; организовать; отрегулировать
届け	とどけ	todoke	отчет; уведомление; регистрация
滞る	とどこおる	todokooru	накапливаться (о недоделанном); запаздывать; застревать; быть просроченным
止まる	とどまる	todomaru	ограничиваться
留める/止める	とどめる	todomeru	остановить; прекратить; положить конец
唱える	となえる	tonaeru	читать; петь; призывать
兎に角	とにかく	tonikaku	во всяком случае; так или иначе; вообще говоря
殿様	とのさま	tonosama	феодал
幕	とばり	tobari	занавес; акт (в игре)
帳	とばり	tobari	занавес
扉	とびら	tobira	дверь; открытие
徒歩	とほ	toho	ходьба
乏しい	とぼしい	toboshii	скудный; бедный
富	とみ	tomi	богатство; удача
富む	とむ	tomu	быть богатым
兎も角	ともかく	tomokaku	во всяком случае; так или иначе; вообще говоря
共稼ぎ	ともかせぎ	tomokasegi	зарабатывать обоим (о муже и жене)
灯	ともしび	tomoshibi	свет (от светильника)
伴う	ともなう	tomonau	сопровождать 
共働き	ともばたらき	tomobataraki	двойной доход
捕らえる	とらえる	toraeru	ухватиться; схватить; поймать; захватить
取りあえず	とりあえず	toriaezu	сразу; в первую очередь
取り扱い	とりあつかい	toriatsukai	лечение; обслуживание; управление
取り扱う	とりあつかう	toriatsukau	обращаться,обходиться с кем-чем-л.; относиться к кому-чему-л.; обращаться с чем-л.
鳥居	とりい	torii	тории (ворота при входе в синтоистский храм)
取り替え	とりかえ	torikae	обмен
取り組む	とりくむ	torikumu	спорт. встречаться с кем-л. (в поединке); серьёзно взяться (за какую-л. задачу)
取り締まり	とりしまり	torishimari	контроль; управление
取り締まる	とりしまる	torishimaru	управлять; контролировать; 
取り調べる	とりしらべる	torishiraberu	исследовать; изучать
取り立てる	とりたてる	toritateru	взимать; собирать; назначать (на должность); покровительствовать; опекать
取り次ぐ	とりつぐ	toritsugu	действовать в качестве агента; объявить (кого-то); передавать (сообщение)
取り除く	とりのぞく	torinozoku	удалить; забрать; отделить
取り引き	とりひき	torihiki	сделка; бизнес
取り巻く	とりまく	torimaku	окружить 
取り混ぜる	とりまぜる	torimazeru	перемешать; положить вместе
取り戻す	とりもどす	torimodosu	чтобы забрать; чтобы восстановить
取り寄せる	とりよせる	toriyoseru	заказывать; посылать за
取り分	とりわけ	toriwake	особенно; прежде всего
蕩ける	とろける	torokeru	растапливать; плавить; очаровывать
	とんだ	tonda	неожиданный; поразительный; ужасный; скандальный
胴	どう	dou	туловище; торс; корпус; каркас
働	どう	dou	работа; труд
同	どう	dou	то же самое
同意	どうい	doui	соглашение; согласие; тот же смысл; одобрение
動員	どういん	douin	мобилизация
同感	どうかん	doukan	cоглашение; симпатия; совпадение
動機	どうき	douki	мотив; стимул
同級	どうきゅう	doukyuu	того же класса,порядка
同居	どうきょ	doukyo	жить вместе
動向	どうこう	doukou	тенденция; движение; отношение
同士	どうし	doushi	товарищ 
同志	どうし	doushi	товарищ; родственная душа
如何して	どうして	doushite	почему?; по какой причине; как; каким образом; с какой целью; зачем
如何しても	どうしても	doushitemo	всеми средствами; любой ценой; несмотря ни на что; во всяком случае; несомненно
同情	どうじょう	doujou	сочувствие; сострадание
道場	どうじょう	doujou	додзе; зал для боевых искусств обучения
何卒	どうぞ	douzo	пожалуйста; любезно; всеми средствами
どうぞ宜しく	どうぞよろしく	douzoyoroshiku	рад встретиться с вами
同調	どうちょう	douchou	радионастройка; равняться на кого-л.; сочувствовать; соглашаться
動的	どうてき	douteki	динамичный 
同等	どうとう	doutou	равенство
堂々	どうどう	doudou	великолепный; великий; впечатляющий
	どうにか	dounika	так или иначе
導入	どうにゅう	dounyuu	введение; в результате чего в; что приводить в
同封	どうふう	doufuu	вкладывать в тот же конверт
同盟	どうめい	doumei	альянс; союз; лига
	どうやら	douyara	кажется; что; так или иначе
動揺	どうよう	douyou	нарушение; беспорядки; дрожь; колебание
動力	どうりょく	douryoku	мощность; движущая сила; динамическая сила
独裁	どくさい	dokusai	диктатура; деспотия
読者	どくしゃ	dokusha	читатель
独自	どくじ	dokuji	оригинальный; своеобразный; характерный
独占	どくせん	dokusen	монополия
独創	どくそう	dokusou	оригинальность
何処	どこ	doko	где; какое место
何処か	どこか	dokoka	где-то; в любом месте; в некоторых отношениях
土産	どさん	dosan	продукт определенного региона
土台	どだい	dodai	фундамент; база; основа
何方	どちら	dochira	который 
土手	どて	dote	набережная; банк
何方	どなた	donata	кто ?
怒鳴る	どなる	donaru	кричать; орать
何の	どの	dono	который; что
土俵	どひょう	dohyou	арена
土木	どぼく	doboku	общественные работы
何れ	どれ	dore	хорошо; теперь; позвольте мне видеть; что (из трех или более)
何々	どれどれ	doredore	которые 
度忘れ	どわすれ	dowasure	забывчивость
鈍感	どんかん	donkan	флегматичность
内閣	ないかく	naikaku	кабинет; министерство
乃至	ないし	naishi	от ... до; между 
内臓	ないぞう	naizou	внутренние органы 
内部	ないぶ	naibu	интерьер; внутри; 
内乱	ないらん	nairan	гражданская война; восстание; мятеж; внутренний конфликт
内陸	ないりく	nairiku	внутри страны
苗	なえ	nae	(рисовая) рассада
尚	なお	nao	ещё (больше); кн. всё (ещё); кн. подобно тому,как...
尚更	なおさら	naosara	(тем) более
中程	なかほど	nakahodo	средний; на полпути
流し	ながし	nagashi	раковина
長々	ながなが	naganaga	долго; затянувшийся 
殴る	なぐる	naguru	ударять; бить; колотить
嘆く	なげく	nageku	вздыхать; жаловаться; горевать
投げ出す	なげだす	nagedasu	бросить; отказаться; пожертвовать; выбросить
和やか	なごやか	nagoyaka	мягкий; спокойный; нежный; гармоничный
名残	なごり	nagori	останки; следы; память
情け	なさけ	nasake	сочувствие; сострадание
情け深い	なさけぶかい	nasakebukai	сострадательный
為さる	なさる	nasaru	сделать
詰る	なじる	najiru	упрекать; ругать; отчитывать
何故	なぜ	naze	почему; как
何故なら	なぜなら	nazenara	потому что
名高い	なだかい	nadakai	известный; знаменитый
雪崩	なだれ	nadare	лавина
懐く	なつく	natsuku	привязаться; полюбить
名付ける	なづける	nazukeru	называть; давать имя
何気ない	なにげない	nanigenai	не обращающий на что-л. внимания; безразличный; как ни в чём не бывало
何しろ	なにしろ	nanishiro	во всяком случае; так или иначе; во всяком случае; в любом случае
何卒	なにとぞ	nanitozo	пожалуйста
何も	なにも	nanimo	ничего
何より	なにより	naniyori	самый; лучший
七日	なぬか	nanuka	седьмой день (месяца)
名札	なふだ	nafuda	дощечка с именем (на дверях); табличка с именем (указывающая место гостя за столом и т.п.)
生臭い	なまぐさい	namagusai	пахнущий рыбой,мясом или кровью
生温い	なまぬるい	namanurui	тепловатый; перен. вялый,нерешительный
生身	なまみ	namami	живая плоть 
鉛	なまり	namari	свинец
鈍る	なまる	namaru	стать менее способным; тускнеть; стать тупым; ослабить
並み	なみ	nami	средний уровень; стандарт; норма; 
滑らか	なめらか	nameraka	гладкость
嘗める	なめる	nameru	лизать; лакать; пробовать на вкус
悩ましい	なやましい	nayamashii	печальный; тягостный
悩ます	なやます	nayamasu	мучить; изводить 
悩み	なやみ	nayami	беда; беспокойство; стресс; боль 
平均	ならし	narashi	равновесие; баланс; средняя; средняя
慣らす	ならす	narasu	приучить
馴らす	ならす	narasu	приручать; укрощать
並びに	ならびに	narabini	и
成り立つ	なりたつ	naritatsu	заключить; состоять из; быть практичным 
成る丈	なるたけ	narutake	насколько это возможно; если это возможно
成るべく	なるべく	narubeku	как можно больше
慣れ	なれ	nare	практика; опыт
馴れ馴れしい	なれなれしい	narenareshii	непринуждённый; фамильярный
難	なん	nan	трудность; дефект
南	なん	nan	юг
	なんか	nanka	вещи; как ...; или что-то в этом роде .. 
何だか	なんだか	nandaka	немного; несколько; так или иначе
	なんだかんだ	nandakanda	то или другое
何て	なんて	nante	как ... !; что ... !
何と	なんと	nanto	что; как; что
何となく	なんとなく	nantonaku	так или иначе; по той или иной причине
何とも	なんとも	nantomo	ничего (с отрицанием); вполне; не немного
何なり	なんなり	nannari	любой; все; 
荷	に	ni	нагрузка; багаж; груз
似通う	にかよう	nikayou	быть похожим; напоминать; иметь общее
面皰	にきび	nikibi	прыщ; акне
賑わう	にぎわう	nigiwau	процветать; сделать процветающий бизнес 
悪い	にくい	nikui	ненавистный; отвратительный 
憎しみ	にくしみ	nikushimi	ненависть
肉親	にくしん	nikushin	кровное родство; кровный родственник
肉体	にくたい	nikutai	тело; плоть
逃げ出す	にげだす	nigedasu	убежать; вырваться из
西日	にしび	nishibi	заходящее солнце
滲む	にじむ	nijimu	распространять; разливаться; сочиться
日夜	にちや	nichiya	днем и ночью; всегда
日当	にっとう	nittou	плата за день; ,дневной заработок
荷造り	にづくり	nizukuri	упаковка; пакетирование; тара
担う	になう	ninau	нести на плече; нести (бремя,обязанности)
二人	ににん	ninin	два человека; два человека; пара; 
にも拘らず	にもかかわらず	nimokakawarazu	несмотря на; тем не менее; 
入手	にゅうしゅ	nyuushu	получение
入賞	にゅうしょう	nyuushou	выиграть приз или место (в конкурсе)
入浴	にゅうよく	nyuuyoku	купаться; купание
尿	にょう	nyou	моча
俄か	にわか	niwaka	Вдруг; внезапно; неожиданно; импровизационно
認識	にんしき	ninshiki	признание 
妊娠	にんしん	ninshin	беременность
人情	にんじょう	ninjou	сопереживание; доброта; сочувствие; человеческая природа; обычаи и нравы
任務	にんむ	ninmu	обязанность; функция; миссия; задача
任命	にんめい	ninmei	назначение; номинация; обозначение
抜かす	ぬかす	nukasu	опустить; не учесть
抜け出す	ぬけだす	nukedasu	выскользнуть; улизнуть 
盗み	ぬすみ	nusumi	кража
沼	ぬま	numa	болото
音	ね	ne	звук; нота
値打ち	ねうち	neuchi	значение; цена; достоинство
寝かせる	ねかせる	nekaseru	положить в постель; сложить 
捻子	ねじ	neji	винт; спираль 
ねじ回し	ねじまわし	nejimawashi	отвертка
捻じれる	ねじれる	nejireru	крутить; вырвать; ввернуть
鼠	ねず	nezu	мышь; крыса; темно-серый 
妬む	ねたむ	netamu	ревновать; завидовать
強請る	ねだる	nedaru	дразнить; уговорить; запрашивать; требовать
熱湯	ねっとう	nettou	кипяток
熱意	ねつい	netsui	рвение; энтузиазм
熱量	ねつりょう	netsuryou	температура
粘り	ねばり	nebari	 вязкость
粘る	ねばる	nebaru	быть липким; быть клейким; упорствовать
値引き	ねびき	nebiki	снижение цены; скидка
根回し	ねまわし	nemawashi	окапывание; перен. подготовка почвы
眠たい	ねむたい	nemutai	сонный
練る	ねる	neru	месить; работать над; полировать
念	ねん	nen	смысл; идея; мысль; чувство; желание; интерес; внимание; забота
年鑑	ねんかん	nenkan	ежегодник
年号	ねんごう	nengou	число года
燃焼	ねんしょう	nenshou	жжение; горение
年生	ねんせい	nensei	ученик/студент n года обчуения 
年長	ねんちょう	nenchou	старшинство
燃料	ねんりょう	nenryou	топливо
年輪	ねんりん	nenrin	годичное кольцо дерева
脳	のう	nou	мозг; память
農耕	のうこう	noukou	сельское хозяйство
農場	のうじょう	noujou	ферма (сельское хозяйство)
農地	のうち	nouchi	земли сельскохозяйственного назначения
納入	のうにゅう	nounyuu	оплата; поставка
逃す	のがす	nogasu	выпустить; позволить бежать
逃れる	のがれる	nogareru	бежать
軒並み	のきなみ	nokinami	ряд домов
鋸	のこぎり	nokogiri	пила
望ましい	のぞましい	nozomashii	желательный
臨む	のぞむ	nozomu	чтобы смотреть на; к лицу; иметь дело с 
乗っ取る	のっとる	nottoru	захватить; оккупировать; узурпировать
長閑	のどか	nodoka	спокойный; тихий
罵る	ののしる	nonoshiru	говорить плохо о ч-л.
延べ	のべ	nobe	отсрочка платежа; рассрочка; кредит
飲み込む	のみこむ	nomikomu	глотать; понять; принять
乗り換え	のりかえ	norikae	пересадка (на поезд,автобус и т.д.)
乗り込む	のりこむ	norikomu	подняться на борт; встать на; сесть в (автомобиль) 
刃	は	ha	лезвие (меча)
派	は	ha	группа; фракция; школа
把握	はあく	haaku	ухватывать; схватывать
肺	はい	hai	легкое
廃棄	はいき	haiki	утилизация; отказ; отбрасывание; отмена
配給	はいきゅう	haikyuu	нормированное распределение; выдача (по карточкам и т.п.)
配偶者	はいぐうしゃ	haiguusha	супруг; супруга; муж
拝啓	はいけい	haikei	уважаемый (вступление в письме)
背景	はいけい	haikei	фон; декорации; обстановка
背後	はいご	haigo	назад; задний
灰皿	はいさら	haisara	пепельница
廃止	はいし	haishi	отмена 
拝借	はいしゃく	haishaku	заимствование
排除	はいじょ	haijo	исключение; удаление; отказ
排水	はいすい	haisui	дренаж
敗戦	はいせん	haisen	поражение 
配置	はいち	haichi	размещение; расстановка; дислокация
配布	はいふ	haifu	распределение
配分	はいぶん	haibun	распределение; выделение
配慮	はいりょ	hairyo	рассмотрение; забота; предусмотрительность
配列	はいれつ	hairetsu	расположение; конфигурация; массив (в программировании)
映える	はえる	haeru	чтобы светить; выглядеть привлекательно; выглядеть красиво
破壊	はかい	hakai	разрушение
墓地	はかち	hakachi	кладбище
捗る	はかどる	hakadoru	добиться прогресса; продвигаться
果ない	はかない	hakanai	мимолетное; преходящее; мгновенное; напрасно; непостоянное 
諮る	はかる	hakaru	консультироваться; советоваться
図る	はかる	hakaru	строить; расчитывать; планировать 
剥がす/剥ぐ	はがす/はぐ	hagasu/ hagu	отрывать; шелушиться; сдирать; отделять
破棄	はき	haki	отмена; аннулирование 
泊	はく	haku	счетное слово для суток пребывания
迫害	はくがい	hakugai	преследование
薄弱	はくじゃく	hakujaku	беспомощность; слабость 
白状	はくじょう	hakujou	признание
派遣	はけん	haken	посылать; отсылать
励ます	はげます	hagemasu	поощрять; подбодрять; поднять (голос)
励む	はげむ	hagemu	прилагать старания; быть усердным
剥げる	はげる	hageru	облупливаться; шелушиться; линять; выцветать
鋏	はさみ	hasami	ножницы
柱	はしら	hashira	столб; колонна
橋渡し	はしわたし	hashiwatashi	мост; посредничество
恥	はじ	haji	позор 
弾く	はじく	hajiku	отбрасывать (щелчком пальца); отталкивать
始め	はじめ	hajime	начало; происхождение
始めまして	はじめまして	hajimemashite	рад встретиться с вами
恥じらう	はじらう	hajirau	стесняться; краснеть
恥じる	はじる	hajiru	стыдиться
蓮	はす	hasu	лотос
筈	はず	hazu	наверное; должно быть
弾む	はずむ	hazumu	быть оживлённым; раскошелиться на что-л.; задыхаться
破損	はそん	hason	повреждение
機	はた	hata	ткацкий станок
果たして	はたして	hatashite	как и ожидалось; действительно
果たす	はたす	hatasu	выполнить; осуществить; достичь
裸足	はだし	hadashi	босиком
蜂蜜	はちみつ	hachimitsu	мед
発掘	はっくつ	hakkutsu	земляные работы; эксгумация; раскопки
発生	はっせい	hassei	вспышка; появление; происхождение
発足	はっそく	hassoku	кн. начало,открытие
初	はつ	hatsu	во-первых; новый
発	はつ	hatsu	отъезд; начало; счетное слово для выстрелов
発育	はついく	hatsuiku	(физический) рост; развитие
発芽	はつが	hatsuga	растущий
発言	はつげん	hatsugen	высказывание; речь; предложение
発病	はつびょう	hatsubyou	возникновение болезни; заболевание
初耳	はつみみ	hatsumimi	что-то слышать в первый раз
果て	はて	hate	конец; предел; результат
果てる	はてる	hateru	быть завершенным; быть исчерпанным; умереть; погибнуть
話し合い	はなしあい	hanashiai	обсуждение; конференция
甚だ	はなはだ	hanahada	очень; чрезвычайно
華々しい	はなばなしい	hanabanashii	блестящий; великолепный; захватывающий
花びら	はなびら	hanabira	лепесток
華やか	はなやか	hanayaka	эффектный; блестящий; великолепный; витиеватый
阻む	はばむ	habamu	задерживать; тормозить; мешать
浜	はま	hama	пляж; побережье
浜辺	はまべ	hamabe	пляж; береговая полоса
填まる	はまる	hamaru	быть впору; подходить к чему-л.; надеваться на что-л.; входить; соответствовать назначению
歯磨	はみがき	hamigaki	средство для чистки зубов; зубная паста
填める	はめる	hameru	войти; вставить; надеть
生やす	はやす	hayasu	отпускать,носить (бороду,усы)
早める	はやめる	hayameru	спешить; ускорять 
流行	はやり	hayari	модно; преобладающий
腹立ち	はらだち	haradachi	гнев
原っぱ	はらっぱ	harappa	открытое поле; пустырь 
張り紙	はりがみ	harigami	наклейка; наклеенная бумага (объявление,плакат)
遥か	はるか	haruka	далеко; на расстоянии 
破裂	はれつ	haretsu	разрыв; взрыв
腫れる	はれる	hareru	набухать (от воспаления); отекать
班	はん	han	группа; партия; раздел
判	はん	han	печать; штамп; постановление
版	はん	han	издание
繁栄	はんえい	hanei	процветание
反感	はんかん	hankan	антипатия; восстание; враждебность
版画	はんが	hanga	постер
反響	はんきょう	hankyou	эхо; реверберации; влияние
判決	はんけつ	hanketsu	судебное решение; постановление; приговор 
反撃	はんげき	hangeki	контратака; контрнаступление 
反射	はんしゃ	hansha	отражение
繁殖	はんしょく	hanshoku	размножение; увеличение; распространение
繁盛	はんじょう	hanjou	процветание; расцвет
反する	はんする	hansuru	быть несовместимым; противостоять; противоречит; бунтовать
判定	はんてい	hantei	суд; решение; приговор
反応	はんのう	hannou	реакция
半端	はんぱ	hanpa	остаток; фрагмент; неполный комплект; фракция; нечет сумма; неполнота
反発	はんぱつ	hanpatsu	неприятие; негативная реакция; отпор
反乱	はんらん	hanran	восстание; мятеж; бунт; восстание 
氾濫	はんらん	hanran	переполненние; наводнение
黴菌	ばいきん	baikin	бактерии 
賠償	ばいしょう	baishou	репарации; возмещения; компенсации
倍率	ばいりつ	bairitsu	диаметр; увеличение
馬鹿馬鹿しい	ばかばかしい	bakabakashii	глупый
馬鹿らしい	ばからしい	bakarashii	абсурдный
漠然	ばくぜん	bakuzen	неясный; смутный; туманный; неопределённый
爆弾	ばくだん	bakudan	бомба
爆破	ばくは	bakuha	взрыв
暴露	ばくろ	bakuro	раскрытие; экспозиция; откровение
化ける	ばける	bakeru	принять форму; измениться в худшую сторону
罰	ばち	bachi	наказание; проклятие; возмездие
	ばてる	bateru	быть исчерпаным; быть изношеным
発条	ばね	bane	пружина
散蒔く	ばらまく	baramaku	разбрасывать; рассыпать; обр. раздавать направо и налево
判	ばん	ban	(личная) печать; штамп; оттиск печати
万	ばん	ban	много; все
万人	ばんじん	banjin	все люди; все; 10000 человек
万能	ばんのう	bannou	универсальный; всемогущий; всемогущий
番目	ばんめ	banme	суффикс порядкового числа
非	ひ	hi	не-
費	ひ	hi	стоимость; расходы
延いては	ひいては	hiiteha	не только ...; но также; в дополнение к; как следствие
控室	ひかえしつ	hikaeshitsu	зал ожидания
控える	ひかえる	hikaeru	удерживаться; быть воздержанным; записывать; ожидать
悲観	ひかん	hikan	пессимизм; разочарование
匹	ひき	hiki	голова; счетное слово для небольших животных животных 
引き上げる	ひきあげる	hikiageru	вывести; оставить; вытащить; уйти в отставку
率いる	ひきいる	hikiiru	предводительствовать; командовать
引き受ける	ひきうける	hikiukeru	предпринять; занять; взять на себя; чтобы нести ответственность; гарантировать; 
引き起こす	ひきおこす	hikiokosu	вызвать
引き下げる	ひきさげる	hikisageru	снести; уменьшить
引きずる	ひきずる	hikizuru	соблазнить; перетащить на; тянуть; чтобы продлить; поддержать
引き取る	ひきとる	hikitoru	взять на себя ответственность; удалиться в укромное место
引き分け	ひきわけ	hikiwake	ничья (в конкурсе)
否決	ひけつ	hiketsu	отказ; отрицание
非行	ひこう	hikou	преступность; проступок
日頃	ひごろ	higoro	нормально; привычно
久しい	ひさしい	hisashii	долгий
久し振り	ひさしぶり	hisashiburi	после долгого времени
悲惨	ひさん	hisan	нищета
秘書	ひしょ	hisho	(частный) секретарь
比重	ひじゅう	hijuu	удельный вес
密か	ひそか	hisoka	тайный; секретный
浸す	ひたす	hitasu	погружать (в жидкость); замачивать; пропитывать
一向	ひたすら	hitasura	серьезно
左利き	ひだりきき	hidarikiki	левша
引っ掻く	ひっかく	hikkaku	в хорошем состоянии
引っ掛ける	ひっかける	hikkakeru	повесить (что-то) на (что-то); подключить; поймать 
必修	ひっしゅう	hisshuu	необходимости (в зависимости)
匹敵	ひってき	hitteki	кн. быть равным; не уступать кому-чему-л.
未	ひつじ	hitsuji	восьмой знак китайского зодиака (Овен 1 вечера - 3 вечера на юго- юго-западу июня)
必然	ひつぜん	hitsuzen	неизбежно; необходимо
一息	ひといき	hitoiki	дыхание; пауза
単	ひとえ	hitoe	один слой 
人柄	ひとがら	hitogara	личность; характер 
一頃	ひところ	hitokoro	один раз; некоторое время назад
人質	ひとじち	hitojichi	заложник; пленник
一筋	ひとすき	hitosuki	линия; напрямик; слепо,не разбирая
一まず	ひとまず	hitomazu	в настоящее время; один раз
一人でに	ひとりでに	hitorideni	сам по себе; автоматически; естественно
酷い	ひどい	hidoi	жестокий; ужасный; тяжелый; серьезный; страшный
日取り	ひどり	hidori	фиксированная дата; назначеный день
雛	ひな	hina	цыпленок; кукла
日向	ひなた	hinata	солнечное место; в солнце
非難	ひなん	hinan	критика; нападки; упрёки
避難	ひなん	hinan	принятие прибежища; наход приюта
日の丸	ひのまる	hinomaru	японский флаг
火花	ひばな	hibana	искра
日々	ひび	hibi	каждый день; ежедневно; день за днем
悲鳴	ひめい	himei	крик; крик
百科事典	ひゃっかじてん	hyakkajiten	энциклопедия
冷やかす	ひやかす	hiyakasu	подтрунивать; высмеивать; издеваться; охлаждать 
日焼け	ひやけ	hiyake	загар
票	ひょう	hyou	этикетка; билет
標語	ひょうご	hyougo	девиз; слоган; лозунг
	ひょっと	hyotto	возможно; случайно
平たい	ひらたい	hiratai	плоский; простой; ясный
比率	ひりつ	hiritsu	коэффициент; доля; процент
肥料	ひりょう	hiryou	навоз; удобрение
比例	ひれい	hirei	доля
疲労	ひろう	hirou	усталость
広まる	ひろまる	hiromaru	распространяться
貧困	ひんこん	hinkon	бедность; лишения
品質	ひんしつ	hinshitsu	качество
品種	ひんしゅ	hinshu	род; сорт; разновидность; порода
貧弱	ひんじゃく	hinjaku	бедные; скудные; несущественное
頻繁	ひんぱん	hinpan	частота
美	び	bi	красота
微笑	びしょう	bishou	улыбка
美術	びじゅつ	bijutsu	искусство; изобразительное искусство
吃驚	びっくり	bikkuri	испуг; удивление
	びっしょり	bisshori	промокший
描写	びょうしゃ	byousha	описание; изображение
	びり	biri	последний в списке
微量	びりょう	biryou	незначительное количество 
敏感	びんかん	binkan	чувствительность; восприимчивость; чувствительность (к); хорошо приспособлены к
貧乏	びんぼう	binbou	бедность
歩	ふ	fu	пешка (в шахматах или сеги)
不意	ふい	fui	вдруг; внезапно; неожиданно; непредвиденно
封	ふう	fuu	печать
封鎖	ふうさ	fuusa	блокада; замораживание
風習	ふうしゅう	fuushuu	обычай
風俗	ふうぞく	fuuzoku	манеры; обычаи
風土	ふうど	fuudo	природные особенности (местности); климат
不可欠	ふかけつ	fukaketsu	незаменимый; необходимымй
深める	ふかめる	fukameru	углубить; чтобы усилить; активизировать
不吉	ふきつ	fukitsu	 невезение; дурное предзнаменование
不況	ふきょう	fukyou	рецессия; депрессия; спад
布巾	ふきん	fukin	посудное полотенце; салфетка
福	ふく	fuku	удача
復旧	ふくきゅう	fukukyuu	реставрация; восстановление; реабилитация
複合	ふくごう	fukugou	комплекс
福祉	ふくし	fukushi	благосостояние; благополучие
覆面	ふくめん	fukumen	маска; вуаль; маскировка
膨れる	ふくれる	fukureru	набухать; расширяться; быть надутым; разбухать; выпирать
不景気	ふけいき	fukeiki	спад активности; тяжелые времена; депрессия; уныние; угрюмость
老ける	ふける	fukeru	в возрасте
布告	ふこく	fukoku	указ; постановление; провозглашение
富豪	ふごう	fugou	богатый человек; миллионер
負債	ふさい	fusai	долг; обязательства
相応しい	ふさわしい	fusawashii	соответствующий
不在	ふざい	fuzai	отсутствие
不山戯る	ふざける	fuzakeru	резвиться; шутить; смеяться над 
負傷	ふしょう	fushou	травма; рана
不審	ふしん	fushin	вопрос; недоверие; подозрительность; странность; неверность
不振	ふしん	fushin	тупость; депрессия; спад; 
不順	ふじゅん	fujun	неправильность
付属	ふぞく	fuzoku	приложенный; приданный; состоящий при ком-чём-л.
負担	ふたん	futan	бремя; нагрузка; ответственность
不調	ふちょう	fuchou	плохое состояние; несогласие; расстройство; спад
復活	ふっかつ	fukkatsu	возрождение; восстановление
復興	ふっこう	fukkou	возрождение; ренессанс; реконструкция
沸騰	ふっとう	futtou	кипение
仏	ふつ	futsu	французский
不図	ふと	futo	вдруг; случайно; случайно; кстати; неожиданно; непреднамеренно
不当	ふとう	futou	несправедливость; нарушение этики; неразумность 
不動産	ふどうさん	fudousan	недвижимость
赴任	ふにん	funin	отправляться (прибывать) к месту нового назначения
腐敗	ふはい	fuhai	распад; разврат
不評	ふひょう	fuhyou	плохая репутация; позор; непопулярность
不便	ふびん	fubin	жаль; сострадание
不服	ふふく	fufuku	неудовлетворенность; недовольство; неодобрение; возражение; жалоба; протест; несогласие
普遍	ふへん	fuhen	универсальность; вездесущность 
踏まえる	ふまえる	fumaeru	стоять на чём-л.; перен. опираться на что-л.
文	ふみ	fumi	письмо; сочинение
不明	ふめい	fumei	неизвестный; скрытый; нечеткий; неопределенный; двусмысленный; неопознанный
扶養	ふよう	fuyou	поддержка; обслуживание
振り	ふり	furi	притворство; внешний вид
振り出し	ふりだし	furidashi	начало; отправной пункт; фин. выдача (напр. векселя); отвар,настойка
不良	ふりょう	furyou	плохое качество
浮力	ふりょく	furyoku	плавучесть 
震わせる	ふるわせる	furuwaseru	дрожать
付録	ふろく	furoku	приложение; дополнение
分	ふん	fun	минута
憤慨	ふんがい	fungai	негодование; обида
紛失	ふんしつ	funshitsu	потеря
噴出	ふんしゅつ	funshutsu	спускание; извержение; выбрасывание
紛争	ふんそう	funsou	спор; проблемы; ссоры
	ふんだん	fundan	многочисленный; обильный; щедрый
奮闘	ふんとう	funtou	тяжелая борьба; напряженные усилия
粉末	ふんまつ	funmatsu	мелкий порошок
部	ぶ	bu	отдел; часть; категория; счетное слово для газет или журналов
部下	ぶか	buka	подчиненный человек
	ぶかぶか	bukabuka	слишком большой; мешковатый
侮辱	ぶじょく	bujoku	оскорбление; презрение
武装	ぶそう	busou	вооружение 
斑	ぶち	buchi	пятна; крапинки 
物資	ぶっし	busshi	товары; материалы
物体	ぶったい	buttai	тело; объект
物議	ぶつぎ	butsugi	общественное обсуждение (критика)
打付ける	ぶつける	butsukeru	ударяться; вбивать (гвоздь); швырять; бросать
仏像	ぶつぞう	butsuzou	изображение Будды (статуя)
無難	ぶなん	bunan	безопасность
部門	ぶもん	bumon	класс; группа; категория; отдел; филиал
ぶら下げる	ぶらさげる	burasageru	повесить; приостановить; болтаться; качаться
	ぶらぶら	burabura	раскачиваться; куда глаза глядят; сложа руки; лениво; слоняться; туда-сюда
武力	ぶりょく	buryoku	военная мощь; сила
無礼	ぶれい	burei	невежливо; грубо
文化財	ぶんかざい	bunkazai	культурные ценности 
分業	ぶんぎょう	bungyou	разделение труда; специализация
文語	ぶんご	bungo	письменность; литературный язык
分散	ぶんさん	bunsan	рассеивание; распыление; рассредоточение; дисперсия
分子	ぶんし	bunshi	числитель; молекула
文書	ぶんしょ	bunsho	документ; письмо; записи; архивы
分担	ぶんたん	buntan	распределение; обмен
分配	ぶんぱい	bunpai	деление; обмен
分母	ぶんぼ	bunbo	знаменатель
分離	ぶんり	bunri	разделение; выделение
分裂	ぶんれつ	bunretsu	 деление; разлом; раскол; разрыв
兵器	へいき	heiki	оружие
閉口	へいこう	heikou	молчать; не знать,что сказать; перен. быть припёртым к стене
平行	へいこう	heikou	(идущий) бок о бок; одновременно; в ряд; в то же время; параллельность
閉鎖	へいさ	heisa	закрытие 
兵士	へいし	heishi	солдат
平常	へいじょう	heijou	нормальный; обычный
平方	へいほう	heihou	площадь ч-л.
並列	へいれつ	heiretsu	расположение в линию
辟易	へきえき	hekieki	кн. пасовать перед чем-л.; отшатываться от чего-л.; отступать
臍	へそ	heso	пупок
隔たる	へだたる	hedataru	быть отдаленным
謙る	へりくだる	herikudaru	осуждать себя и хвалить слушателя
経る	へる	heru	пройти; испытать
編	へん	hen	редактирование; составление
偏	へん	hen	стороны; слева радикала характера; наклоняя; склонив к; предвзятым
変革	へんかく	henkaku	изменение; реформа; революция; переворот; () Реформация
返還	へんかん	henkan	возвращение; восстановление
偏見	へんけん	henken	предубеждение; узкий взгляд
返済	へんさい	hensai	погашение
変遷	へんせん	hensen	изменение; переход; превратности
返答	へんとう	hentou	ответ
変動	へんどう	hendou	изменение; колебание
弁解	べんかい	benkai	объяснение; оправдание; защита; извините
便宜	べんぎ	bengi	удобство; размещение; преимущество; целесообразность
弁護	べんご	bengo	защита (словом); вступаться за кого-л.
弁償	べんしょう	benshou	компенсация; возмещение ущерба 
弁論	べんろん	benron	обсуждение; дискуссия; аргумент
	ぺこぺこ	pekopeko	очень голодный
穂	ほ	ho	колос 
保育	ほいく	hoiku	уход за больными; воспитание; кормление грудью
倣	ほう	hou	подражать; следовать
法案	ほうあん	houan	законопроект 
崩壊	ほうかい	houkai	коллапс; распад; разрушение 
法学	ほうがく	hougaku	закон; юриспруденция
放棄	ほうき	houki	отказ 
宝器	ほうき	houki	выдающийся человек
封建	ほうけん	houken	феодальный
豊作	ほうさく	housaku	обильный урожай; рекордный урожай
方策	ほうさく	housaku	план; политика
奉仕	ほうし	houshi	служение; предложение по сниженной цене
方式	ほうしき	houshiki	форма; метод; система
放射	ほうしゃ	housha	излучение
放射能	ほうしゃのう	houshanou	радиоактивность
報酬	ほうしゅう	houshuu	вознаграждение 
放出	ほうしゅつ	houshutsu	выделение; излучение
報じる/報ずる	ほうじる/ほうずる	houjiru/ houzuru	информировать; сообщать
放置	ほうち	houchi	оставить как есть; оставить на волю случая; оставить в покое 
法廷	ほうてい	houtei	зал суда
報道	ほうどう	houdou	информация; отчет
褒美	ほうび	houbi	награда; приз
葬る	ほうむる	houmuru	похоронить; предать забвению 
放り込む	ほうりこむ	hourikomu	бросать в
放り出す	ほうりだす	houridasu	выкинуть; стрелять; изгнать; сдаться; отказаться 
飽和	ほうわ	houwa	насыщенность
保温	ほおん	hoon	сохранение тепля; теплоизоляция
捕獲	ほかく	hokaku	захват
保管	ほかん	hokan	опека; хранение 
補給	ほきゅう	hokyuu	питание; поставка; пополнение
補強	ほきょう	hokyou	компенсации; укрепление
保険	ほけん	hoken	страхование; гарантия
捕鯨	ほげい	hogei	китобойный промысел 
誇る	ほこる	hokoru	хвастаться; гордиться
綻びる	ほころびる	hokorobiru	распарываться; рваться; распускаться (о бутонах,почках)
保護	ほご	hogo	уход; защита; жилье; опека; благосклонность; покровительство
乾	ほし	hoshi	высушенный
干し物	ほしもの	hoshimono	вывешенное для просушки бельё
保守	ほしゅ	hoshu	консерватизм; сохранение
保障	ほしょう	hoshou	гарантия; безопасность; гарантии; залог 
補償	ほしょう	hoshou	компенсация; возмещение ущерба
補充	ほじゅう	hojuu	дополнение; комплектование; пополнение
補助	ほじょ	hojo	помощь; поддержка 
舗装	ほそう	hosou	тротуар; дорожное покрытие
補足	ほそく	hosoku	добавка; дополнение
発作	ほっさ	hossa	приступ; припадок; спазм
	ほっと	hotto	чувствовать облегчение
頬っぺた	ほっぺた	hoppeta	щека
辺り	ほとり	hotori	(в) окрестности; вблизи; рядом
殆ど	ほとんど	hotondo	в основном; почти
解く	ほどく	hodoku	отстегивать
施す	ほどこす	hodokosu	выполнять; осуществлять; подавать (милостыню); оказывать (помощь)
保母	ほぼ	hobo	няня,воспитательница (в детском саду и т.п.)
保養	ほよう	hoyou	сохранение здоровья; оздоровление; отдых
捕吏	ほり	hori	полицейский
捕虜	ほりょ	horyo	военнопленный; пленный
滅びる	ほろびる	horobiru	гибнуть; разрушаться
滅ぼす	ほろぼす	horobosu	уничтожить; свергнуть; чтобы крушения; к гибели
本格	ほんかく	honkaku	губить; уничтожать
本館	ほんかん	honkan	главное здание
本気	ほんき	honki	серьезность; правда; святость
本質	ほんしつ	honshitsu	сущность; истинная природа; реальность
本体	ほんたい	hontai	вещество; реальная форма 
本音	ほんね	honne	реальное намерение; мотив
本の	ほんの	honno	просто; только 
本能	ほんのう	honnou	инстинкт
本場	ほんば	honba	центр; место производства; лучшее место (для произрастания,разведения чего-л.)
本文	ほんぶん	honbun	текст (документа); основная часть (письма)
本名	ほんみょう	honmyou	настоящее имя
卯	ぼう	bou	Заяц (4-й знак китайского гороскопа); арх. направление на восток; арх. время с 5 часов до 7 часов утра
防衛	ぼうえい	bouei	защита; самооборона
防火	ぼうか	bouka	пожарная безопасность; пожаротушение
妨害	ぼうがい	bougai	нарушение; препятствие; помеха
紡績	ぼうせき	bouseki	прядение
呆然	ぼうぜん	bouzen	ошарашеный; преодолеть с удивлением; в пустой изумлению
膨脹	ぼうちょう	bouchou	расширение; отек; увеличение; рост
冒頭	ぼうとう	boutou	вступительная часть
暴動	ぼうどう	boudou	восстание; бунт 
暴風	ぼうふう	boufuu	буря; шторм
暴力	ぼうりょく	bouryoku	насилие
募金	ぼきん	bokin	сбор средств 
牧師	ぼくし	bokushi	пастор; священник
母校	ぼこう	bokou	альма-матер
没収	ぼっしゅう	bosshuu	конфискация; секвестр
坊ちゃん	ぼっちゃん	bocchan	сын (2 или 3 лица)
	ぼつぼつ	botsubotsu	постепенно; тут и там; пятна
没落	ぼつらく	botsuraku	разруха; падение; коллапс
	ぼやく	boyaku	ворчать; жаловаться
	ぼやける	boyakeru	стать тусклым; стать размытым
藍褸	ぼろ	boro	тряпка; лом; потрепанные одежды; дефект; захудалый 
枚	まい	mai	счетное слово для плоских объектов (например листов бумаги)
埋蔵	まいぞう	maizou	зарывать; закапывать (в землю)
舞う	まう	mau	танцевать; порхать
真上	まうえ	maue	чуть выше; прямо над головой
前売り	まえうり	maeuri	предварительная продажа; бронирование
前置き	まえおき	maeoki	предисловие; введение
前もって	まえもって	maemotte	заранее; ранее
任す	まかす	makasu	поручить; оставить для человека
負かす	まかす	makasu	победить
賄う	まかなう	makanau	кормить; поставлять (провизию); оплачивать; финансировать
曲がる	まがる	magaru	гнуться; быть изогнутым; 
巻	まき	maki	свиток,рулон; том,книга; завод (часов)
紛らわしい	まぎらわしい	magirawashii	запутанный; вводящий в заблуждение; двусмысленнымй; неоднозначний
紛れる	まぎれる	magireru	смешаться с чем-л.; затеряться в чём-л.; стать неразличимым; быть увлечённым чем-л.
膜	まく	maku	мембрана; пленка
捲る	まくる	makuru	закатывать; засучивать (рукава); подбирать (подол)
真心	まこころ	makokoro	искренность; преданность
誠	まこと	makoto	правда; верность; искренность; доверие; уверенность
真に	まことに	makotoni	действительно; на самом деле 
	まごつく	magotsuku	путать; быть взволнованным
正しく	まさしく	masashiku	безусловно; без сомнения; очевидно; 
正に	まさに	masani	правильно; безусловно; 
勝る	まさる	masaru	чтобы преуспеть; чтобы превзойти; чтобы превосходить
増し	まし	mashi	прибавка; с каждым (днём,годом)
真下	ました	mashita	прямо под 
況して	まして	mashite	еще больше; еще меньше (с отрицанием); не говоря уже о 
交える	まじえる	majieru	смешивать; обмениваться
交わる	まじわる	majiwaru	пересечь; чтобы пересечь; чтобы связать с; чтобы смешаться с; заинтересовать; чтобы присоединиться
麻酔	ますい	masui	анестезия
益々	ますます	masumasu	все больше и больше
不味い	まずい	mazui	неаппетитный; неприятный (вкус,ситуация); некрасивый; неуклюжий
股	また	mata	пах; бедро
跨がる	またがる	matagaru	сидеть верхом; быть переброшенным (о мосте); лежать по обе стороны; простираться
跨ぐ	またぐ	matagu	оседлать
瞬き	またたき	matataki	подмигивание; мерцание (света)
待ち合わせ	まちあわせ	machiawase	назначение
間違う	まちがう	machigau	ошибиться; быть неправильным 
待ち遠しい	まちどおしい	machidooshii	с нетерпением жду
待ち望む	まちのぞむ	machinozomu	смотреть с тревогой; с нетерпением ждать
区々	まちまち	machimachi	разнообразные; разноречивые
	まっき	makki	последние годы (месяцы,дни); завершающая стадия
真っ二つ	まっぷたつ	mapputatsu	на две равные части
的	まと	mato	марка; цель
纏まり	まとまり	matomari	разрешение; заключение; законченность; связность; единство; согласованность
纏め	まとめ	matome	вывод; заключение
免れる	まぬかれる	manukareru	вырваться из; спастись от; избежать; уклониться; предотвратить; ускользнуть; быть освобожденным
招き	まねき	maneki	приглашение
麻痺	まひ	mahi	паралич; онемение; оцепенение
眩しい	まぶしい	mabushii	ослепительный; сияющий
目蓋	まぶた	mabuta	веко
間々	まま	mama	иногда; часто
間もなく	まもなく	mamonaku	в ближайшее время; до тех пор; в течение короткого времени
眉	まゆ	mayu	бровь
鞠	まり	mari	мяч
丸ごと	まるごと	marugoto	в полном объеме; в целом; полностью
丸っきり	まるっきり	marukkiri	полностью; совершенно так же; как если
丸で	まるで	marude	вполне; полностью; полностью; вообще; как будто; как будто; так сказать
丸々	まるまる	marumaru	полностью
丸める	まるめる	marumeru	округлить; свернуться калачиком; прельстить; задобрить 
満月	まんげつ	mangetsu	полнолуние
満場	まんじょう	manjou	весь зал; вся аудитория (публика); все присутствующие
真ん中	まんなか	mannaka	средний; центр
真ん前	まんまえ	manmae	прямо перед; под носом
真ん丸い	まんまるい	manmarui	идеально круглый
三	み	mi	3
見合い	みあい	miai	смотрины; соответствие; равновесие
見合わせる	みあわせる	miawaseru	переглядываться; откладывать; приостанавливать свою деятельность; сочетать браком
見落とす	みおとす	miotosu	не заметить
未開	みかい	mikai	нецивилизованный; некультурный; дикий
味覚	みかく	mikaku	вкус; чувство вкуса
見掛ける	みかける	mikakeru	заметить; чтобы увидеть
三日月	みかずき	mikazuki	новолуние; полумесяц
見方	みかた	mikata	точка зрения
見苦しい	みぐるしい	migurushii	неприглядный; некрасивый
見込み	みこみ	mikomi	надежда; перспективы; ожидания
未婚	みこん	mikon	незамужний(ая)
惨め	みじめ	mijime	несчастный
未熟	みじゅく	mijuku	неопытность; незрелость; сырье; неопытность
微塵	みじん	mijin	частица; атом
見すぼらしい	みすぼらしい	misuborashii	потертый; захудалый
見せびらかす	みせびらかす	misebirakasu	показать; выставлять напоказ
見せ物	みせもの	misemono	шоу; выставка
満たす	みたす	mitasu	наполнять (наливать,накладывать); пополнять; удовлетворять ()
乱す	みだす	midasu	выбросить; приводить в беспорядок; тревожить
乱れる	みだれる	midareru	запутаться; быть неупорядоченным; 
未知	みち	michi	пока не известный
導く	みちびく	michibiku	ориентироваться; показывать дорогу
身近	みぢか	mijika	 близкий; знакомый
密集	みっしゅう	misshuu	толпа; груда
密接	みっせつ	missetsu	связаные между собой; близкий
見っともない	みっともない	mittomonai	стыдно; неприлично
蜜	みつ	mitsu	нектар; мед
密度	みつど	mitsudo	плотность
見積り	みつもり	mitsumori	оценка; цитата
未定	みてい	mitei	пока не определена; не определились; в ожидании
見通し	みとおし	mitooshi	перспектива; беспрепятственный обзор; прогноз; прогноз; перспектива; понимание
源	みなもと	minamoto	источник; происхождение
身なり	みなり	minari	личная явка
峰	みね	mine	пик; гребень
見逃す	みのがす	minogasu	пропустить; не заметить; оставить на свободе
見晴らし	みはらし	miharashi	вид
身振り	みぶり	miburi	жест
見舞	みまい	mimai	посещение (больного и т.п.); наведение справки (о чьём-л. здоровье); выражение сочувствия (озабоченности)
脈	みゃく	myaku	импульс
未練	みれん	miren	сожаление 
見渡す	みわたす	miwatasu	смотреть вдаль на; окидывать взглядом
民主	みんしゅ	minshu	демократия
民宿	みんしゅく	minshuku	комнаты,сдаваемые отдыхающим
民族/民俗	みんぞく	minzoku	расы; нации; народные обычаи
六	む	mu	6
無意味	むいみ	muimi	ерунда; бессмысленность
向き	むき	muki	направление; ситуация; аспект 
無口	むくち	mukuchi	сдержанность
向け	むけ	muke	для ~; ориентированный на ~
婿	むこ	muko	зять
無効	むこう	mukou	недействительный; неэффективный; недоступный
無言	むごん	mugon	молчание
毟る	むしる	mushiru	выбрать; сорвать
無邪気	むじゃき	mujaki	невинность; простодушие
結び	むすび	musubi	узел; вывод 
結び付き	むすびつき	musubitsuki	соединение; связь
結び付く	むすびつく	musubitsuku	быть связаным; объединиться
結び付ける	むすびつける	musubitsukeru	объединить; присоединиться; связать; прикрепить с узлом
無線	むせん	musen	беспроводной 
無駄遣い	むだづかい	mudazukai	тратить деньги на; зря тратить силы
無断	むだん	mudan	без разрешения; без уведомления
無知	むち	muchi	невежество
無茶	むちゃ	mucha	абсурдно; неразумно; чрезмерно; абсурд
無茶苦茶	むちゃくちゃ	muchakucha	перемешаный; перепутаный; неразумный
空しい	むなしい	munashii	вакантный; бесполезный; напрасный; пустой; неэффективный
無念	むねん	munen	огорчение; сожаление
無能	むのう	munou	неэффективность; некомпетентность
無闇に	むやみに	muyamini	необоснованно; нелепо; безрассудно нескромно; наугад
無用	むよう	muyou	бесполезно; тщетно; не нужно 
群がる	むらがる	muragaru	толпиться; собираться в толпу
無論	むろん	muron	конечно; естественно
名産	めいさん	meisan	знаменитый продукт
名称	めいしょう	meishou	название
命中	めいちゅう	meichuu	попадание (в цель)
名簿	めいぼ	meibo	список (реестр) имен
名誉	めいよ	meiyo	честь; почёт; слава
明瞭	めいりょう	meiryou	ясность
明朗	めいろう	meirou	яркость; четкость 
目方	めかた	mekata	вес
恵み	めぐみ	megumi	благословение
恵む	めぐむ	megumu	благословлять; проявлять милосердие к
目覚しい	めざましい	mezamashii	блестящий; великолепный; яркий; замечательный
目覚める	めざめる	mezameru	просыпаться
召す	めす	mesu	уст. о действиях 2-го и 3-го лица звать,посылать за кем-л.; надевать; покупать; садиться (в экипаж,поезд и т.п.); принимать (ванну)
雌	めす	mesu	самка
滅茶苦茶	めちゃくちゃ	mechakucha	абсурдно; неразумно; чрезмерное 
目付き	めつき	metsuki	выражение глаз; взгляд
滅亡	めつぼう	metsubou	крушение; разруха; развал; разрушение
愛でたい	めでたい	medetai	благоприятный
目眩	めまい	memai	головокружение; 
目盛	めもり	memori	деления на шкале; шкала
面会	めんかい	menkai	интервью
免除	めんじょ	menjo	освобождение; разряд
面する	めんする	mensuru	быть обращённым (в какую-л. сторону)
面目	めんぼく	menboku	лицо; честь; репутация; престиж; достоинство
設ける	もうける	moukeru	создать; установить
申し入れる	もうしいれる	moushiireru	предложить 
申し込み	もうしこみ	moushikomi	предложение; заявление; заявка; требование; бронирование
申出	もうしで	moushide	заявление; предложение,представление; требование
申し出る	もうしでる	moushideru	представить; заявить; требовать
申し分	もうしぶん	moushibun	замечание; возражение; жалоба
盲点	もうてん	mouten	слепое пятно
猛烈	もうれつ	mouretsu	жестокость; ярость; ярость
藻掻く	もがく	mogaku	бороться; извиваться; корчиться
目録	もくろく	mokuroku	каталог; список
目論見	もくろみ	mokuromi	план; схема; проект; программа
模型	もけい	mokei	модель; манекен; макет
模索	もさく	mosaku	кн. искать ощупью
若し	もし	moshi	если; в случае; предполагая
若しかしたら	もしかしたら	moshikashitara	возможно; может быть; если вдруг
若しかして	もしかして	moshikashite	возможно
若しかすると	もしかすると	moshikasuruto	возможно; может быть; если вдруг
若しくは	もしくは	moshikuha	или; в противном случае
若しも	もしも	moshimo	если
齎らす	もたらす	motarasu	приносить; уносить; влечь за собой,вызывать,порождать
凭れる	もたれる	motareru	прислониться; опереться; откинуться; быть тяжелым (о пище)
持ち	もち	mochi	долговечность; сохранность; прочность,носкость; доля (расходов,ответственности)
持ち切り	もちきり	mochikiri	единственной темой разговора было...; говорили только о...
物体ない	もったいない	mottainai	не заслуживающее; недостойное
以て	もって	motte	с; по посредством; потому что; ввиду
専ら	もっぱら	moppara	исключительно; всецело; главным образом; преимущественно
持て成す	もてなす	motenasu	приём; обслуживание; гостеприимство
持てる	もてる	moteru	быть популярным; иметь успех
基	もとい	motoi	основа
物置き	ものおき	monooki	кладовая
物好き	ものずき	monozuki	любопытство
物足りない	ものたりない	monotarinai	неудовлетворённый; недостаточный
最早	もはや	mohaya	уже сейчас
模範	もはん	mohan	образец; модель; пример
模倣	もほう	mohou	имитация; копирование
揉める	もめる	momeru	не соглашаться; оспаривать
腿	もも	momo	бедра
催す	もよおす	moyoosu	проводить,устраивать (собрание,вечер и т.п.); чувствовать позыв к чему-л.
漏らす	もらす	morasu	дать просочиться; выпустить; проявлять; давать выход (чувствам); пропускать; опускать; упускать; выбалтывать
盛り上がる	もりあがる	moriagaru	подниматься; расти; вздыматься
漏る	もる	moru	протекать; течь
漏れる	もれる	moreru	просачиваться; проникать; просвечивать 
脆い	もろい	moroi	ломкий; хрупкимй 
	もろに	moroni	полностью; весь путь
問	もん	mon	проблема; вопрос
矢	や	ya	стрелка
哉	や	ya	вопросительный знак
喧しい	やかましい	yakamashii	шумный; строгий; суетливый
野外	やがい	yagai	поля; окраина; под открытым небом; пригороды
軈て	やがて	yagate	в скором времени; в ближайшее время; в конце концов; затем
夜行	やぎょう	yagyou	ночной путь (путешествие); ночной поезд
役職	やくしょく	yakushoku	сообщение; управленческая позиция; официальная позиция
役立つ	やくだつ	yakudatsu	быть полезным; служить цели
役場	やくば	yakuba	ратуша
夜具	やぐ	yagu	постельные принадлежности
優	やさ	yasa	нежный; ласковый
屋敷	やしき	yashiki	дворец
養う	やしなう	yashinau	поддерживать; развивать
社	やしろ	yashiro	синтоистский храм
野心	やしん	yashin	честолюбие; притязания; амбиции; предательство
易い	やすい	yasui	легко
安っぽい	やすっぽい	yasuppoi	дешево выглядящий; безвкусный; незначительный
休める	やすめる	yasumeru	отдохнуть; приостановить; чтобы дать облегчение
野生	やせい	yasei	дикий
矢鱈に	やたらに	yatarani	случайно; по неосторожности; слепо
夜中	やちゅう	yachuu	всю ночь; всю ночь
奴	やっこ	yakko	слуга
やっ付ける	やっつける	yattsukeru	бить
矢っ張り	やっぱり	yappari	как я думал; по-прежнему; несмотря на; абсолютно
野党	やとう	yatou	оппозиционная партия
病	やまい	yamai	болезнь 
闇	やみ	yami	темнота; подпольная торговля; тьма
病む	やむ	yamu	болеть
止むを得ない	やむをえない	yamuoenai	ничего не поделаешь; неизбежно
稍	やや	yaya	немного; частично; несколько; на короткое время; в то время как
	ややこしい	yayakoshii	озадачивающий; запутанный; сложный 
遣り通す	やりとおす	yaritoosu	довести до конца; добиться; завершить
やり遂げる	やりとげる	yaritogeru	выполнять
遣る	やる	yaru	давать; дарить; посылать; пускать кого-л.,куда-л.; делать; исполнять; заниматься чем-л.; 
和らげる	やわらげる	yawarageru	смягчать; облегчать
優位	ゆうい	yuui	преобладание; господство; превосходство
憂鬱	ゆううつ	yuuutsu	депрессия; меланхолия; уныние 
有益	ゆうえき	yuueki	выгодно 
優越	ゆうえつ	yuuetsu	превосходство; преобладание 
勇敢	ゆうかん	yuukan	храбрость; героизм 
有機	ゆうき	yuuki	органический
夕暮れ	ゆうぐれ	yuugure	вечер; сумерки
融資	ゆうし	yuushi	финансирование; кредит
有する	ゆうする	yuusuru	владеть; быть наделенным
融通	ゆうずう	yuuzuu	кредитование; финансирование
優勢	ゆうせい	yuusei	превосходство; высшая сила; преобладание; перевес
優先	ゆうせん	yuusen	предпочтение; приоритет
誘導	ゆうどう	yuudou	руководство; ведущий; внедрение; побуждение
優美	ゆうび	yuubi	изысканность; элегантность
有望	ゆうぼう	yuubou	хорошие перспективы 
遊牧	ゆうぼく	yuuboku	кочевой образ жизни
夕焼け	ゆうやけ	yuuyake	закат
有力	ゆうりょく	yuuryoku	влияние; известность; мощность
幽霊	ゆうれい	yuurei	фантом; призрак; привидение 
誘惑	ゆうわく	yuuwaku	искушение; соблазн 
揺さぶる	ゆさぶる	yusaburu	трясти; встряхнуть; качаться 
茹でる	ゆでる	yuderu	кипятить
	ゆとり	yutori	свободное место
指差す	ゆびさす	yubisasu	указать на
弓	ゆみ	yumi	лук (и стрелы)
揺らぐ	ゆらぐ	yuragu	качаться; трястись; дрожать
緩む	ゆるむ	yurumu	стать свободным; ослабить
緩める	ゆるめる	yurumeru	чтобы ослабить; замедлить
緩やか	ゆるやか	yuruyaka	мягкий
世	よ	yo	мир; общество; поколение
好い	よい	yoi	хорошо
要因	よういん	youin	основной фактор; основная причина
溶液	ようえき	youeki	раствор (жидкость)
用件	ようけん	youken	бизнес
養護	ようご	yougo	защита; уход за больными 
用紙	ようし	youshi	чистый бланк
様式	ようしき	youshiki	стиль; форма; узор
要する	ようする	yousuru	требовать; нуждаться в чём-л.; ждать в засаде
要請	ようせい	yousei	претензии; требования; просьба
養成	ようせい	yousei	обучение; развитие
様相	ようそう	yousou	аспект
用品	ようひん	youhin	предметы чего-л.; принадлежности; инвентарь
洋風	ようふう	youfuu	западный стиль
用法	ようほう	youhou	правила использования
要望	ようぼう	youbou	спрос на; запрос
余暇	よか	yoka	отдых; свободное время 
予感	よかん	yokan	предчувствие 
余興	よきょう	yokyou	развлечения
預金	よきん	yokin	депозит; банковский счет
抑圧	よくあつ	yokuatsu	притеснение; гнёт
浴室	よくしつ	yokushitsu	ванная комната
抑制	よくせい	yokusei	подавление
欲深い	よくふかい	yokufukai	жадный
欲望	よくぼう	yokubou	желание; аппетит
寄こす	よこす	yokosu	отправлять; пересылать
横綱	よこづな	yokozuna	высший титул в борьбе сумо и его обладатель
葦	よし	yoshi	тростник; камыш
善し悪し	よしあし	yoshiashi	хорошо это или плохо; достоинства и недостатки; качество; пригодность
予想	よそう	yosou	ожидание; прогноз на встречу
余所見	よそみ	yosomi	глядя в сторону 
余地	よち	yochi	свободное пространство (место)
依って	よって	yotte	поэтому; как следствие; соответственно; из-за
余程	よっぽど	yoppodo	очень; в значительной степени; вполне
与党	よとう	yotou	правительственная партия 
呼び止める	よびとめる	yobitomeru	бросить вызов; чтобы позвонить кому-то; чтобы остановить
夜更かし	よふかし	yofukashi	не спать до поздней ночи
夜更け	よふけ	yofuke	поздно вечером
読み上げる	よみあげる	yomiageru	читать вслух; прочитать (до конца)
寄り掛かる	よりかかる	yorikakaru	прислониться; откинуться; опереться; полагаться на
宜しく	よろしく	yoroshiku	ну; правильно; соответственно; с наилучшими пожеланиями; очень приятно (пери знакомстве)
弱まる	よわまる	yowamaru	стихать; ослабить; быть истощеныым; чтобы быть удрученным; недоумевать
弱める	よわめる	yowameru	ослаблять
弱る	よわる	yowaru	ослабить; быть удрученным; быть истощенным; быть удрученный 
来場	らいじょう	raijou	посещаемость
酪農	らくのう	rakunou	молочное хозяйство
落下	らっか	rakka	падение 
楽観	らっかん	rakkan	оптимизм
濫用	らんよう	ranyou	неправильное обращения и использование; присвоения; используя в избытке
理屈	りくつ	rikutsu	теория; причина
利根	りこん	rikon	интеллект
利子	りし	rishi	проценты (на капитал)
利潤	りじゅん	rijun	(чистая) прибыль
理性	りせい	risei	причина; чувство
利息	りそく	risoku	проценты (на капитал)
立体	りったい	rittai	твердое тело
立法	りっぽう	rippou	законодательство 
利点	りてん	riten	преимущество; бал в пользу
略語	りゃくご	ryakugo	аббревиатура; акроним
略奪	りゃくだつ	ryakudatsu	грабеж; разбой
流	りゅう	ryuu	метод; манера
流通	りゅうつう	ryuutsuu	оборот денег или товаров; поток воды или воздуха; распределение
了	りょう	ryou	отделка; завершение; понимание
料	りょう	ryou	материал; плата
領域	りょういき	ryouiki	площадь; территория; поле; область; режим
了解	りょうかい	ryoukai	понимание; согласие 
領海	りょうかい	ryoukai	территориальные воды
両極	りょうきょく	ryoukyoku	оба полюса (северный и южный);; . обе крайности
良好	りょうこう	ryoukou	благоприятный; удовлетворительный
良識	りょうしき	ryoushiki	здравый смысл
良質	りょうしつ	ryoushitsu	хорошее качество 
了承	りょうしょう	ryoushou	признание; понимание (например,отнеситесь с пониманием...)
良心	りょうしん	ryoushin	совесть
領地	りょうち	ryouchi	территория; власть
領土	りょうど	ryoudo	 территория; владение
両立	りょうりつ	ryouritsu	совместимость; сосуществование
旅客	りょかく	ryokaku	пассажир 
旅券	りょけん	ryoken	паспорт
履歴	りれき	rireki	личная история; биография
理論	りろん	riron	теория
輪	りん	rin	счетное слово для колес и цветов
林業	りんぎょう	ringyou	лесное хозяйство
類似	るいじ	ruiji	аналогичный
類推	るいすい	ruisui	аналогия
冷酷	れいこく	reikoku	жестокость; безжалостность
冷蔵	れいぞう	reizou	холодильник
冷淡	れいたん	reitan	прохлада; равнодушие
恋愛	れんあい	renai	любовь; страсть
連休	れんきゅう	renkyuu	выходные дни
連日	れんじつ	renjitsu	изо дня в день
連中	れんじゅう	renjuu	группа; компания 
連帯	れんたい	rentai	солидарность
連邦	れんぽう	renpou	содружество; федерация 
連盟	れんめい	renmei	лига; союз; альянс
老衰	ろうすい	rousui	старческая немощь
朗読	ろうどく	roudoku	чтение вслух
浪費	ろうひ	rouhi	напрасная трата
労力	ろうりょく	rouryoku	труд; усилия 
碌な	ろくな	rokuna	удовлетворительный; достойный
碌に	ろくに	rokuni	хорошо; достаточно 
露骨	ろこつ	rokotsu	откровенный; открытый; прямой; бросающийся в глаза; явный; неприличный
論議	ろんぎ	rongi	обсуждение
論理	ろんり	ronri	логика
和	わ	wa	сумма; гармония; мир
我がまま	わがまま	wagamama	эгоизм; своеволие; каприз
枠	わく	waku	рамка
惑星	わくせい	wakusei	планета
技	わざ	waza	искусство; техника
態と	わざと	wazato	нарочно
態々	わざわざ	wazawaza	прямо; специально 
煩わしい	わずらわしい	wazurawashii	хлопотный; раздражающий
渡り鳥	わたりどり	wataridori	перелетная птица 
詫び	わび	wabi	извинение
和風	わふう	wafuu	японский стиль
和文	わぶん	wabun	японский текст
藁	わら	wara	солома
割合に	わりあいに	wariaini	сравнительно
割り当て	わりあて	wariate	назначение; распределение; квота; нормирование
割り込む	わりこむ	warikomu	протискиваться; втискиваться; встревать; вмешиваться
割り算	わりざん	warizan	деление (математика)
割引き	わりびき	waribiki	скидка; снижение; скидка в 10%
悪者	わるもの	warumono	плохой человек
	アイデア	aidea	идея
	アクセル	akuseru	ускоритель
	アップ	apu	вверх
	アプローチ	apuroochi	подход (в гольфе)
	アマチュア	amachua	любитель
	アラブ	arabu	арабский
	アルカリ	arukari	щелочь
	アルミ	arumi	алюминий (Al); алюминий
	アワー	awaa	час
	アンケート	ankeeto	анкета 
	アンコール	ankooru	бис
	イエス	iesu	Иисус; да
	インターチェンジ	intaachenji	обмен
	インターナショナル	intaanashonaru	международный
	インターフォン	intaafon	внутренняя связь
	インテリ	interi	умник; интеллигенция
	インフォメーション	infomeeshon	информация
	インフレ	infure	инфляция
	ウェートレス	weetoresu	официантка
	エアメール	eameeru	воздушная почта
	エレガント	ereganto	элегантный
	エンジニア	enjinia	инженер
	オーケー	ookee	хорошо
	オートマチック	ootomachikku	автоматический
	オープン	oopun	открытый
	オリエンテーション	orienteeshon	ориентация
	オレンジ	orenji	оранжевый
	オンライン	onrain	онлайн
	カーペット	kaapetto	ковер
	カクテル	kakuteru	коктейль
	カット	katto	вырезать; резка
	カテゴリー	kategorii	категория
	カムバック	kamubakku	возвращение
	カメラマン	kameraman	кинооператор
	カルテ	karute	медецинская карта
	カンニング	kanningu	хитрость; обман
	ガイド	gaido	экскурсовод
	ガイドブック	gaidobukku	путеводитель
	ガレージ	gareeji	гараж 
	キャッチ	kyacchi	улов
	キャリア	kyaria	карьера
	クイズ	kuizu	викторина
	クラブ	kurabu	клуб; краб
	クレーン	kureen	кран
	グラフ	gurafu	график
	グレー	guree	серый; серый
	ゲスト	gesuto	гость
	コーナー	koonaa	угол
	コマーシャル	komaasharu	коммерческий
	コミュニケーション	komyunikeeshon	коммуникация
	コメント	komento	комментарий
	コンタクト	kontakuto	контакт; контактные линзы
	コンテスト	kontesuto	конкурс
	コントラスト	kontorasuto	контрастировать
	コントロール	kontorooru	контроль
	コンパス	konpasu	компас
	サイクル	saikuru	цикл
	サイズ	saizu	размер
	サボる	saboru	саботировать; прогуливать
	サンキュー	sankyuu	спасибо
	サンタクロース	santakuroosu	Санта Клаус
	シート	shiito	лист
	システム	shisutemu	система
	シック	shikku	шик
	シナリオ	shinario	сценарий
	ショー	shoo	шоу
	ショック	shokku	шок
	ジーパン	jiipan	джинсы; полукомбинезон
	ジャズ	jazu	джаз
	ジャンパー	janpaa	куртка; джемпер
	ジャンプ	janpu	прыжок
	ジャンボ	janbo	гигантский
	ジャンル	janru	жанр
	スタジオ	sutajio	студия
	スチーム	suchiimu	пар
	ストライキ	sutoraiki	забастовка
	ストレス	sutoresu	стресс
	ストロー	sutoroo	солома
	ストロボ	sutorobo	стробоскоп; фонарь
	スピード	supiido	скорость
	スプリング	supuringu	весна
	スペース	supeesu	пространство
	スポーツカー	supootsukaa	спортивный автомобиль
	スラックス	surakkusu	широкие брюки
	セール	seeru	продажа
	セクション	sekushon	раздел
	セックス	sekkusu	секс
	セレモニー	seremonii	церемония
	センス	sensu	здравый смысл (для музыки тактичность и т.д.)
	ゼリー	zerii	желе; Джерри
	ソース	soosu	источник
	ソックス	sokkusu	носки
	ソロ	soro	соло
	タイトル	taitoru	название
	タイピスト	taipisuto	машинистка
	タイマー	taimaa	таймер
	タイミング	taimingu	синхронизация
	タイム	taimu	время
	タイムリー	taimurii	своевременно
	タイヤ	taiya	шины
	タイル	tairu	плитка
	タレント	tarento	талант; звезда; личность
	タワー	tawaa	башня
	ダース	daasu	дюжина
	ダウン	daun	вниз
	ダブる	daburu	совпадать ; удваивать; остаться на второй учебный год 
	ダンプ	danpu	свалка
	チームワーク	chiimuwaaku	работа в команде
	チェンジ	chenji	изменение
	チャイム	chaimu	перезвон
	チャンネル	channeru	канал
	ティッシュペーパー	tisshupeepaa	папиросная бумага
	テレックス	terekkusu	телекс
	データ	deeta	данные
	デコレーション	dekoreeshon	украшение
	デザート	dezaato	десерт
	デザイン	dezain	дизайн
	デッサン	dessan	набросок 
	デモンストレーション	demonsutoreeshon	демонстрация
	トーン	toon	тон
	トラブル	toraburu	трудность
	トランジスター	toranjisutaa	транзистор
	ドライ	dorai	сухой
	ドライクリーニング	doraikuriiningu	химчистка
	ドライバー	doraibaa	водитель; отвертка
	ドライブイン	doraibuin	вбивать
	ドリル	doriru	дрель
	ナイター	naitaa	ночная игра
	ナプキン	napukin	салфетка
	ナンセンス	nansensu	ерунда
	ニュー	nyuu	новый
	ニュアンス	nyuansu	нюанс
	ネガ	nega	(фото) негатив
	ノイローゼ	noirooze	невроз 
	ハンガー	hangaa	ангар; вешалка; голод
	バー	baa	бар
	バッジ	bajji	значок
	バット	batto	летучая мышь 
	パジャマ	pajama	пижама
	パチンコ	pachinko	пачинко (японский пинбол)
	パトカー	patokaa	патрульная машина
	パンク	panku	выброс; прокол
	ヒント	hinto	намек
	ビールス	biirusu	вирус
	ビジネス	bijinesu	бизнес
	ファイト	faito	борьба
	ファイル	fairu	файл
	ファン	fan	вентилятор
	フィルター	firutaa	(камера) фильтр
	フェリー	ferii	паром
	フォーム	foomu	пена; форма
	フロント	furonto	фронт
	ブーツ	buutsu	ботинки
	ブーム	buumu	бум
	ブザー	buzaa	зуммер
	ブルー	buruu	синий
	ベース	beesu	база; бас
	ベスト	besuto	лучше; жилет
	ベストセラー	besutoseraa	бестселлер
	ペア	pea	пара; груша
	ホース	hoosu	шланг
	ホール	hooru	зал; дыра
	ボイコット	boikotto	бойкот
	ボルト	boruto	вольт; болт
	ポーズ	poozu	пауза
	ポイント	pointo	точка
	ポジション	pojishon	положение
	ポット	potto	горшок
	ポンプ	ponpu	насос
	マーク	maaku	знак
	マスコミ	masukomi	СМИ
	マッサージ	massaaji	массаж
	ミスプリント	misupurinto	опечатка
	ミセス	misesu	миссис
	ミュージック	myuujikku	музыка
	ミリ	miri	милли; 0,001
	ムード	muudo	настроение
	メーカー	meekaa	производитель
	メッセージ	messeeji	сообщение
	メディア	media	медиа; СМИ
	メロディー	merodii	мелодия
	モーテル	mooteru	мотель
	モニター	monitaa	(компьютер) монитор
	ヤング	yangu	молодой
	ユニーク	yuniiku	уникальный
	ユニフォーム	yunifoomu	форма
	ライス	raisu	рис
	ラベル	raberu	этикетка
	ランプ	ranpu	лампа
	ルーズ	ruuzu	свободно
	ルール	ruuru	правило
	レース	reesu	гонка
	レギュラー	regyuraa	регулярный
	レクリエーション	rekurieeshon	отдых
	レッスン	ressun	урок
	レディー	redii	леди
	レバー	rebaa	рычаг 
	レンジ	renji	диапазон
	レンタカー	rentakaa	прокат автомобилей 
	レントゲン	rentogen	рентгеновский 
	ロープ	roopu	веревка
ローマ字	ローマじ	roomaji	латинские буквы
	ロマンチック	romanchikku	романтический
	ワット	watto	ватт