	あいかわらず	aikawarazu	as ever; as usual; the same
	アイデア/アイディア	aidea/aidia	idea
	あいまい	aimai	vague; ambiguous
遭う	あう	au	to meet; to encounter (undesirable nuance)
扇ぐ	あおぐ	aogu	to fan; to flap
青白い	あおじろい	aojiroi	pale; pallid
	あかんぼう	akanbou	baby
明き	あき	aki	room; time to spare; emptiness
	あきれる	akireru	to be amazed; to be shocked
	アクセント	akusento	accent
	あくび	akubi	yawn
飽くまで	あくまで	akumade	to the end; to the last; stubbornly
明け方	あけがた	akegata	dawn
揚げる	あげる	ageru	to lift; to fry
挙げる	あげる	ageru	to raise; to fly
	あげる (=やる)	ageru (=yaru)	to do for
憧れる	あこがれる	akogareru	to long for; to yearn after; to admire
足跡	あしあと	ashiato	footprints
味わう	あじわう	ajiwau	to taste; to savor; to relish
預かる	あずかる	azukaru	to keep in custody; to receive on deposit; to take charge of
暖まる	あたたまる	atatamaru	to warm up; to get warm
暖める	あたためる	atatameru	to warm; to heat
	あたりまえ	atarimae	usual; common; ordinary
	あちらこちら	achirakochira	here and there
厚かましい	あつかましい	atsukamashii	impudent; shameless; brazen
圧縮	あっしゅく	asshuku	compression; condensation; pressure
宛名	あてな	atena	address; direction
	あてはまる	atehamaru	to be applicable; to come under (a category); to fulfill
	あてはめる	atehameru	to apply; to adapt
暴れる	あばれる	abareru	to act violently; to rage; to struggle; to be riotous
脂	あぶら	abura	fat; tallow; lard
	あぶる	aburu	to scorch
	あふれる	afureru	to flood; to overflow; to brim over
雨戸	あまど	amado	sliding storm door
甘やかす	あまやかす	amayakasu	to pamper; to spoil
余る	あまる	amaru	to remain; to be left over; to be in excess; to be too many
編物	あみもの	amimono	knitting; web
編む	あむ	amu	to knit
危うい	あやうい	ayaui	dangerous; critical; grave
怪しい	あやしい	ayashii	suspicious; dubious; doubtful
荒い	あらい	arai	rough; rude; wild
粗い	あらい	arai	coarse; rough
	あらすじ	arasuji	outline; summary
争う	あらそう	arasou	to dispute; to argue; to be at variance; to compete
改めて	あらためて	aratamete	another time; again; over again; anew; formally
改める	あらためる	aratameru	to change; to alter; to reform; to revise
著す	あらわす	arawasu	to write; to publish
有難い	ありがたい	arigatai	grateful; thankful; welcome; appreciated; evoking gratitude
在る	ある	aru	to live; to be
	あれこれ	arekore	one thing or another; this and that; this or that
	あわただしい	awatadashii	busy; hurried; confused; flurried
	あわてる	awateru	to become confused
安易	あんい	ani	easy-going
案外	あんがい	angai	unexpectedly
	アンテナ	antena	antenna
言い出す	いいだす	iidasu	to start talking; to speak; to tell; to propose; to suggest; to break the ice
言い付ける	いいつける	iitsukeru	to tell; to tell on (someone); to order
意義	いぎ	igi	meaning; significance
生き生き	いきいき	ikiiki	vividly; lively
	いきなり	ikinari	(uk) abruptly; suddenly; all of a sudden; without warning
育児	いくじ	ikuji	childcare; nursing; upbringing
幾分	いくぶん	ikubun	somewhat
生け花	いけばな	ikebana	(1) flower arrangement
以後	いご	igo	after this; from now on; hereafter; thereafter
以降	いこう	ikou	on and after; hereafter; thereafter
	イコール	ikooru	equal
勇ましい	いさましい	isamashii	brave; valiant; gallant; courageous
衣食住	いしょくじゅう	ishokujuu	necessities of life (food; clothing; etc.)
意地悪	いじわる	ijiwaru	malicious; ill-tempered; unkind
	いちいち	ichiichi	one by one; separately
一応	いちおう	ichiou	once; tentatively; in outline; for the time being
一段と	いちだんと	ichidanto	greater; more; further; still more
一流	いちりゅう	ichiryuu	first class; top grade; foremost; top-notch
逸	いつ	itsu	 passivity; idleness
一昨日	いっさくじつ	issakujitsu	day before yesterday
一昨年	いっさくねん	issakunen	year before last
一斉	いっせい	issei	simultaneous; all at once
一旦	いったん	ittan	once; for a moment; one morning; temporarily
一定	いってい	ittei	fixed; settled; definite
	いつのまにか	itsunomanika	before one knows; unnoticed; unawares
移転	いてん	iten	moving; transfer; demise
井戸	いど	ido	water well
緯度	いど	ido	latitude (nav.)
従姉妹	いとこ	itoko	cousin (female)
威張る	いばる	ibaru	to be proud; to swagger
嫌がる	いやがる	iyagaru	to hate; to dislike
	いよいよ	iyoiyo	more and more; all the more; increasingly; at last; beyond doubt
煎る	いる	iru	to parch; to fry
炒る	いる	iru	to parch; to fry
入れ物	いれもの	iremono	container; case; receptacle
	インキ	inki	ink
	インタビュー	intabyuu	interview
引力	いんりょく	inryoku	gravity
	ウーマン	uuman	woman
	ウール	uuru	wool
	ウエートレス	ueetoresu	waitress
植木	うえき	ueki	garden shrubs; trees; potted plant
飢える	うえる	ueru	to starve
浮ぶ	うかぶ	ukabu	to float; to rise to surface; to come to mind
浮かべる	うかべる	ukaberu	to float; to express; to look (sad; glad)
浮く	うく	uku	to float; to become merry; to become loose
承る	うけたまわる	uketamawaru	(hum) to hear; to be told; to know
受取	うけとり	uketori	receipt
受け持つ	うけもつ	ukemotsu	to take (be in) charge of
薄暗い	うすぐらい	usugurai	dim; gloomy
薄める	うすめる	usumeru	to dilute; to water down
打合せ	うちあわせ	uchiawase	business meeting; previous arrangement; appointment
打ち消す	うちけす	uchikesu	to deny; to negate; to contradict
討つ	うつ	utsu	to attack; to avenge
	うっかり	ukkari	carelessly; thoughtlessly; inadvertently
映す	うつす	utsusu	to project; to reflect; to cast (shadow)
写る	うつる	utsuru	to be photographed; to be projected
映る	うつる	utsuru	to be reflected; to harmonize with; to come out (photo)
	うどん	udon	noodles (Japanese)
有無	うむ	umu	yes or no; existence; flag indicator (comp); presence or absence marker
埋める	うめる	umeru	to bury; to fill up; to fill (a seat; a vacant position)
敬う	うやまう	uyamau	to show respect; to honour
裏返す	うらがえす	uragaesu	to turn inside out; to turn (something) over
裏口	うらぐち	uraguchi	backdoor; rear entrance
占う	うらなう	uranau	to forecast; to predict
恨み	うらみ	urami	resentment
恨む	うらむ	uramu	to curse; to feel bitter
羨ましい	うらやましい	urayamashii	envious; enviable
羨む	うらやむ	urayamu	to envy
売上	うりあげ	uriage	amount sold; proceeds
売り切れ	うりきれ	urikire	sold-out
売り切れる	うりきれる	urikireru	to be sold out
売行き	うれゆき	ureyuki	sales
	うろうろ	urouro	loiteringly; aimless wandering
運河	うんが	unga	canal; waterway
	うんと	unto	a great deal; very much
英文	えいぶん	eibun	sentence in English
英和	えいわ	eiwa	English-Japanese (e.g. dictionary)
	ええと	eeto	let me see; well; er....
液体	えきたい	ekitai	liquid; fluid
	エチケット	echiketto	etiquette
絵の具	えのぐ	enogu	colors; paints
	エプロン	epuron	apron
偉い	えらい	erai	great; celebrated; eminent; terrible; awful; famous; remarkable; excellent
宴会	えんかい	enkai	party; banquet
園芸	えんげい	engei	horticulture; gardening
演劇	えんげき	engeki	play (theatrical)
円周	えんしゅう	enshuu	circumference
遠足	えんそく	ensoku	trip; hike; picnic
延長	えんちょう	enchou	extension; elongation; prolongation; lengthening
煙突	えんとつ	entotsu	chimney
追い掛ける	おいかける	oikakeru	to chase or run after someone; to run down; to pursue
追い越す	おいこす	oikosu	to pass (e.g. car); to outdistance; to outstrip
	オイル	oiru	oil; engine oil; kerosene
応援	おうえん	ouen	aid; assistance; help; reinforcement
王女	おうじょ	oujo	princess
応ずる	おうずる	ouzuru	to answer; to respond; to meet; to satisfy; to accept
応接	おうせつ	ousetsu	reception
応対	おうたい	outai	receiving; dealing with
往復	おうふく	oufuku	(col) round trip; coming and going; return ticket
欧米	おうべい	oubei	Europe and America; the West
応用	おうよう	ouyou	application; put to practical use
	オーケストラ	ookesutora	orchestra
	おおざっぱ	oozappa	rough (not precise); broad; sketchy
大通り	おおどおり	oodoori	main street
	オートメーション	ootomeeshon	automation
	オーバーコート	oobaakooto	overcoat
大凡	おおよそ	ooyoso	about; roughly; as a rule; approximately
お帰り	おかえり	okaeri	return; welcome
	おかけください	okakekudasai	please sit down; please have a seat
	おかげさまで	okagesamade	Thanks to god; thanks to you
	おかず	okazu	side dish; accompaniment for rice dishes
拝む	おがむ	ogamu	to worship; to beg; to make a supplication
お代わり	おかわり	okawari	second helping; another cup
補う	おぎなう	oginau	to compensate for
	おきのどくに	okinodokuni	my sympathies; that's too bad; my condolences
屋外	おくがい	okugai	outdoors
	おくさん	okusan	(hon) wife; your wife; madam
送り仮名	おくりがな	okurigana	part of word written in kana
	おげんきで	ogenkide	Stay safe
怠る	おこたる	okotaru	to neglect; to be off guard; to be feeling better
押える	おさえる	osaeru	to stop; to restrain; to seize; to repress; to suppress; to press down
	おさきに	osakini	before; ahead; previously
納める	おさめる	osameru	to obtain; to reap; to pay; to supply; to accept
治める	おさめる	osameru	(1) to govern; to manage; (2) to subdue
惜しい	おしい	oshii	regrettable; disappointing; precious
お辞儀	おじぎ	ojigi	bow
伯父さん/小父さん/叔父さん	おじさん	ojisan	middle-aged gentleman; uncle
	おしゃれ	oshare	smartly dressed; someone smartly dressed; fashion-conscious
	おじゃまします	ojamashimasu	Excuse me for disturbing you
教わる	おそわる	osowaru	to be taught
	おだいじに	odaijini	Take care of yourself
落着く	おちつく	ochitsuku	to calm down; to settle down
御手洗	おてあらい	otearai	font of purifying water placed at entrance of shrine
お出掛け	おでかけ	odekake	about to start out; just about to leave or go out
お手伝いさん	おてつだいさん	otetsudaisan	maid
	おどかす	odokasu	to threaten; to coerce
落し物	おとしもの	otoshimono	lost property
	おととい	ototoi	day before yesterday
	おととし	ototoshi	year before last
	おとなしい	otonashii	obedient; docile; quiet
驚かす	おどろかす	odorokasu	to surprise; to frighten; to create a stir
	おねがいします	onegaishimasu	please
各々	おのおの	onoono	each; every; either; respectively; severally
伯母さん/叔母さん	おばさん	obasan	(hon) aunt; middle-aged lady
	おはよう	ohayou	(abbr) Good morning
お参り	おまいり	omairi	worship; shrine visit
	おまたせしました	omataseshimashita	Sorry to have kept you waiting
	おまちください	omachikudasai	Please wait a moment
	おまちどおさま	omachidoosama	Sorry to have kept you waiting
	おめでたい	omedetai	happy event; matter for congratulation; auspicious event; pregnancy
思い掛けない	おもいがけない	omoigakenai	unexpected; casual
思い込む	おもいこむ	omoikomu	to be under impression that; to be convinced that
思いっ切り	おもいっきり	omoikkiri	with all one's strength; with all one's heart; resignation; resolution
思い付く	おもいつく	omoitsuku	to think of; to hit upon
重たい	おもたい	omotai	heavy; massive; serious
	おやすみ	oyasumi	(1) holiday; absence; rest; (2) (exp) Good night
	おやつ	oyatsu	(1) between meal snack; afternoon refreshment
親指	おやゆび	oyayubi	thumb
	オルガン	orugan	organ
卸す	おろす	orosu	to sell wholesale; grated (vegetables)
恩恵	おんけい	onkei	grace; favor; blessing; benefit
温室	おんしつ	onshitsu	greenhouse
温泉	おんせん	onsen	spa; hot spring; onsen
温帯	おんたい	ontai	temperate zone
御中	おんちゅう	onchuu	and Company; Messrs.
蚊	か	ka	mosquito
	カーブ	kaabu	(1) curve; (2) curve ball (baseball)
貝	かい	kai	shell; shellfish
開会	かいかい	kaikai	opening of a meeting
会館	かいかん	kaikan	meeting hall; assembly hall
改札	かいさつ	kaisatsu	examination of tickets
解散	かいさん	kaisan	breakup; dissolution
海水浴	かいすいよく	kaisuiyoku	sea bathing; seawater bath
回数	かいすう	kaisuu	number of times; frequency
回数券	かいすうけん	kaisuuken	book of tickets
改正	かいせい	kaisei	revision; amendment; alteration
快晴	かいせい	kaisei	good weather
解説	かいせつ	kaisetsu	explanation; commentary
改造	かいぞう	kaizou	(1) remodeling; (2) modding (comp)
開通	かいつう	kaitsuu	opening; open
回転	かいてん	kaiten	rotation; revolution; turning
解答	かいとう	kaitou	answer; solution
回答	かいとう	kaitou	reply; answer
外部	がいぶ	gaibu	the outside; external
解放	かいほう	kaihou	release; liberation; emancipation
開放	かいほう	kaihou	open; throw open; liberalization
海洋	かいよう	kaiyou	ocean
概論	がいろん	gairon	intro; outline; general remarks
帰す	かえす	kaesu	to send back
却って	かえって	kaette	on the contrary; rather; all the more; instead
代える	かえる	kaeru	to exchange; to interchange; to substitute; to replace
反る	かえる	kaeru	to warp; to be warped; to curve
家屋	かおく	kaoku	house; building
係わる	かかわる	kakawaru	to concern oneself in; to have to do with; to affect; to influence; to stick to (opinions)
書留	かきとめ	kakitome	writing down; putting on record; recording; making a note of; registration (of mail)
書取	かきとり	kakitori	dictation
垣根	かきね	kakine	hedge
掻く	かく	kaku	to scratch; to perspire
嗅ぐ	かぐ	kagu	to sniff; to smell
架空	かくう	kakuu	aerial; overhead; fiction; fanciful
各自	かくじ	kakuji	individual; each
拡充	かくじゅう	kakujuu	expansion
学術	がくじゅつ	gakujutsu	science; learning; scholarship
各地	かくち	kakuchi	every place; various places
拡張	かくちょう	kakuchou	expansion; extension; enlargement; escape (ESC)
角度	かくど	kakudo	angle
学年	がくねん	gakunen	year in school; grade in school
学部	がくぶ	gakubu	department of a university; undergraduate
格別	かくべつ	kakubetsu	exceptional
確率	かくりつ	kakuritsu	probability
学力	がくりょく	gakuryoku	scholarship; knowledge; literary ability
掛け算	かけざん	kakezan	multiplication
可決	かけつ	kaketsu	approval; adoption (e.g. motion; bill); passage
火口	かこう	kakou	a burner; origin of a fire
下降	かこう	kakou	downward; descent; fall; drop; subsidence
重なる	かさなる	kasanaru	to be piled up; lie on top of one another; overlap each other
重ねる	かさねる	kasaneru	to pile up; to put something on another; to heap up; to add; to repeat
飾り	かざり	kazari	decoration
火山	かざん	kazan	volcano
	かしこまりました	kashikomarimashita	certainly!
貸し出し	かしだし	kashidashi	lending; loaning
過失	かしつ	kashitsu	error; blunder; accident
果実	かじつ	kajitsu	fruit; nut; berry.
貸間	かしま	kashima	room to let
貸家	かしや	kashiya	house for rent
個所	かしょ	kasho	passage; place; point; part
過剰	かじょう	kajou	excess; over-
	かじる	kajiru	to chew; to bite (at); to gnaw; to nibble
課税	かぜい	kazei	taxation
下線	かせん	kasen	underline; underscore
	カセット	kasetto	cassette (tape)
加速	かそく	kasoku	acceleration
加速度	かそくど	kasokudo	acceleration
固い	かたい	katai	stubborn; firm (not viscous or easily moved)
堅い	かたい	katai	hard (esp. wood); steadfast; honorable; stuffy writing
片仮名	かたかな	katakana	katakana
片付く	かたづく	katazuku	to put in order; to dispose of; to solve
塊	かたまり	katamari	lump; mass; clod; cluster
固まる	かたまる	katamaru	to harden; to solidify; to become firm; to become certain
片道	かたみち	katamichi	one-way (trip)
傾く	かたむく	katamuku	to incline toward; to slant; to lurch
片寄る	かたよる	katayoru	to be one-sided; to incline; to be partial
学科	がっか	gakka	study subject; course of study
学会	がっかい	gakkai	scientific society; academic meeting
楽器	がっき	gakki	musical instrument
学級	がっきゅう	gakkyuu	grade in school
担ぐ	かつぐ	katsugu	to shoulder; to carry on shoulder
括弧	かっこ	kakko	parenthesis; brackets
活字	かつじ	katsuji	printing type
活躍	かつやく	katsuyaku	activity
活力	かつりょく	katsuryoku	vitality; energy
仮定	かてい	katei	assumption; supposition; hypothesis
過程	かてい	katei	process
課程	かてい	katei	course; curriculum
仮名	かな	kana	(n) alias; pseudonym; pen name
仮名遣い	かなづかい	kanazukai	kana orthography; syllabary spelling
鐘	かね	kane	bell; chime
加熱	かねつ	kanetsu	heating
兼ねる	かねる	kaneru	to hold (position); to serve; to be unable
	カバー	kabaa	cover (ex. book)
過半数	かはんすう	kahansuu	majority
被せる	かぶせる	kabuseru	to cover (with something)
釜	かま	kama	iron pot; kettle
紙屑	かみくず	kamikuzu	wastepaper
神様	かみさま	kamisama	god
剃刀	かみそり	kamisori	razor
	ガム	gamu	chewing gum
貨物	かもつ	kamotsu	cargo; freight
	かゆい	kayui	itchy; itching
歌謡	かよう	kayou	song; ballad
殻	から	kara	shell; husk; hull; chaff
	カラー	karaa	collar; color; colour
	からかう	karakau	to ridicule; to tease; to banter with; to make fun of
空っぽ	からっぽ	karappo	empty; vacant; hollow
	かるた	karuta	(n) playing cards (pt: carta)
枯れる	かれる	kareru	to wither; to die (plant); to be blasted (plant)
	カロリー	karorii	calorie
	かわいがる	kawaigaru	to love; to be affectionate
乾かす	かわかす	kawakasu	to dry (clothes; etc.); to desiccate
渇く	かわく	kawaku	to be thirsty
為替	かわせ	kawase	money order; exchange
瓦	かわら	kawara	roof tile
代る	かわる	kawaru	(v5r; vi) to take the place of; to relieve; to be substituted for
間隔	かんかく	kankaku	space; interval; SPC
換気	かんき	kanki	ventilation
感激	かんげき	kangeki	deep emotion; impression; inspiration
関西	かんさい	kansai	Kansai
鑑賞	かんしょう	kanshou	appreciation
感ずる	かんずる	kanzuru	to feel; to sense
間接	かんせつ	kansetsu	indirection; indirectness
乾燥	かんそう	kansou	dry; arid; insipid; dehydrated
感想	かんそう	kansou	impressions; thoughts
観測	かんそく	kansoku	observation
寒帯	かんたい	kantai	frigid zone
官庁	かんちょう	kanchou	government office; authorities
勘違い	かんちがい	kanchigai	misunderstanding; wrong guess
缶詰	かんづめ	kanzume	packing (in cans); canning; canned goods; tin can
乾電池	かんでんち	kandenchi	dry cell; battery
関東	かんとう	kantou	eastern half of Japan; including Tokyo
観念	かんねん	kannen	(1) idea; notion; conception; (2) sense (e.g. of duty)
乾杯	かんぱい	kanpai	toast (drink)
看板	かんばん	kanban	sign; signboard; doorplate; poster
看病	かんびょう	kanbyou	nursing (a patient)
冠	かんむり	kanmuri	crown; diadem; first; best
漢和	かんわ	kanwa	Chinese Character-Japanese (e.g. dictionary)
気圧	きあつ	kiatsu	atmospheric pressure
器械	きかい	kikai	instrument
着替え	きがえ	kigae	changing clothes; change of clothes
機関車	きかんしゃ	kikansha	locomotive; engine
飢饉	ききん	kikin	famine
器具	きぐ	kigu	utensil
期限	きげん	kigen	term; period
記号	きごう	kigou	symbol; code
刻む	きざむ	kizamu	to mince; to carve; to engrave
儀式	ぎしき	gishiki	ceremony; rite; ritual; service
基準/規準	きじゅん	kijun	standard; basis; criteria; norm
起床	きしょう	kishou	rising; getting out of bed
着せる	きせる	kiseru	to put on clothes
基礎	きそ	kiso	foundation; basis
気体	きたい	kitai	vapour; gas
基地	きち	kichi	base
	きっかけ	kikkake	chance; start; cue; excuse
	ぎっしり	gisshiri	tightly; fully
基盤	きばん	kiban	foundation; basis
客席	きゃくせき	kyakuseki	guest seating
客間	きゃくま	kyakuma	parlor; guest room
	ギャング	gyangu	gang
	キャンパス	kyanpasu	campus
休業	きゅうぎょう	kyuugyou	closed (e.g. store); business suspended; shutdown; holiday
休講	きゅうこう	kyuukou	lecture cancelled
休息	きゅうそく	kyuusoku	rest; relief; relaxation
給与	きゅうよ	kyuuyo	allowance; grant; supply
休養	きゅうよう	kyuuyou	rest; break; recreation
清い	きよい	kiyoi	clear; pure; noble
強化	きょうか	kyouka	strengthen; intensify; reinforce; solidify
境界	きょうかい	kyoukai	boundary
行事	ぎょうじ	gyouji	event; function
恐縮	きょうしゅく	kyoushuku	shame; very kind of you; sorry to trouble
教養	きょうよう	kyouyou	culture; education; refinement; cultivation
行列	ぎょうれつ	gyouretsu	(1) line; procession; (2) matrix (math)
漁業	ぎょぎょう	gyogyou	fishing (industry)
曲線	きょくせん	kyokusen	curve
規律	きりつ	kiritsu	order; rules; law
斬る	きる	kiru	(v5r) to behead; to murder
気を付ける	きをつける	kiotsukeru	to be careful; to pay attention; to take care
金魚	きんぎょ	kingyo	goldfish
区域	くいき	kuiki	limits; boundary; domain; zone; sphere; territory
偶数	ぐうすう	guusuu	even number
空想	くうそう	kuusou	daydream; fantasy; fancy; vision
空中	くうちゅう	kuuchuu	sky; air
	クーラー	kuuraa	cooler; air conditioner
釘	くぎ	kugi	nail
区切る	くぎる	kugiru	to punctuate; to cut off; to mark off; to stop; to put an end to
櫛	くし	kushi	comb
	くしゃみ	kushami	sneeze
苦情	くじょう	kujou	complaint; troubles; objection
苦心	くしん	kushin	pain; trouble
屑	くず	kuzu	waste; scrap
崩す	くずす	kuzusu	to destroy; to pull down; to make change (money)
薬指	くすりゆび	kusuriyubi	ring finger
崩れる	くずれる	kuzureru	to collapse; to crumble
砕く	くだく	kudaku	to break; to smash
砕ける	くだける	kudakeru	to break; to be broken
	くたびれる	kutabireru	to get tired; to wear out
	くだらない	kudaranai	good-for-nothing; stupid; trivial; worthless
下る	くだる	kudaru	to get down; to descend
唇	くちびる	kuchibiru	lips
口紅	くちべに	kuchibeni	lipstick
	くっつく	kuttsuku	to adhere to; to keep close to
	くっつける	kuttsukeru	to attach
	くどい	kudoi	verbose; importunate; heavy (taste)
句読点	くとうてん	kutouten	punctuation marks
配る	くばる	kubaru	to distribute; to deliver
工夫	くふう	kufuu	labourer; worker
区分	くぶん	kubun	division; section; classification
組合せ	くみあわせ	kumiawase	combination
組み立てる	くみたてる	kumitateru	to assemble; to set up; to construct
汲む	くむ	kumu	(1) to draw (water); to dip; to scoop; to pump
酌む	くむ	kumu	to serve sake
悔しい	くやしい	kuyashii	regrettable; mortifying; vexing
悔やむ	くやむ	kuyamu	to mourn
	クリーニング	kuriiningu	cleaning; dry cleaning; laundry service
	くるむ	kurumu	to be engulfed in; to be enveloped by; to wrap up
	くれぐれも	kureguremo	repeatedly; sincerely; earnestly
	くわえる	kuwaeru	hold in one’s mouth
郡	ぐん	gun	country; district
稽古	けいこ	keiko	practice; training; study
敬語	けいご	keigo	honorific; term of respect
蛍光灯	けいこうとう	keikoutou	fluorescent lamp; person who is slow to react
形式	けいしき	keishiki	form; formality; format; math expression
継続	けいぞく	keizoku	continuation
毛糸	けいと	keito	knitting wool
経度	けいど	keido	longitude
系統	けいとう	keitou	system; family line; geological formation
芸能	げいのう	geinou	public entertainment; accomplishments; attainments
競馬	けいば	keiba	horse racing
警備	けいび	keibi	defense; guard; policing; security
形容詞	けいようし	keiyoushi	true adjective
形容動詞	けいようどうし	keiyoudoushi	adjectival noun; quasi-adjective
外科	げか	geka	surgical department
毛皮	けがわ	kegawa	fur; skin; pelt
激増	げきぞう	gekizou	sudden increase
下車	げしゃ	gesha	alighting; getting off
下旬	げじゅん	gejun	month (last third of)
下水	げすい	gesui	drainage; sewage; ditch; gutter; sewerage
削る	けずる	kezuru	to cut down little by little; to take a percentage
桁	けた	keta	column; beam; digit
下駄	げた	geta	geta (Japanese footwear); wooden clogs
血圧	けつあつ	ketsuatsu	blood pressure
血液	けつえき	ketsueki	blood
月給	げっきゅう	gekkyuu	monthly salary
傑作	けっさく	kessaku	masterpiece; best work; boner; blunder
月末	げつまつ	getsumatsu	end of the month
気配	けはい	kehai	indication; market trend; worry
下品	げひん	gehin	vulgarity; meanness; indecency; coarseness
煙い	けむい	kemui	smoky
蹴る	ける	keru	to kick
けれど/けれども			but; however
険しい	けわしい	kewashii	inaccessible place; sharp eyes
見学	けんがく	kengaku	inspection; study by observation; field trip
謙虚	けんきょ	kenkyo	modesty; humility
原稿	げんこう	genkou	manuscript; copy
原産	げんさん	gensan	place of origin; habitat
原始	げんし	genshi	origin; primeval
研修	けんしゅう	kenshuu	training
厳重	げんじゅう	genjuu	strict; rigour; severe; firm
謙遜	けんそん	kenson	humble; humility; modesty
県庁	けんちょう	kenchou	prefectural office
限度	げんど	gendo	limit; bounds
現に	げんに	genni	actually; really
顕微鏡	けんびきょう	kenbikyou	microscope
原理	げんり	genri	principle; theory; fundamental truth
原料	げんりょう	genryou	raw materials
碁	ご	go	Go (board game of capturing territory)
恋しい	こいしい	koishii	(1) dear; beloved; darling; (2) yearned for
請う	こう	kou	to ask; to request
工員	こういん	kouin	factory worker
強引	ごういん	gouin	overbearing; coercive; pushy; forcible; high-handed
公害	こうがい	kougai	public nuisance; pollution
高級	こうきゅう	koukyuu	high class; high grade
公共	こうきょう	koukyou	public; community; public service; society; communal
工芸	こうげい	kougei	industrial arts
孝行	こうこう	koukou	filial piety
交差	こうさ	kousa	cross
講師	こうし	koushi	lecturer
工事	こうじ	kouji	construction work
公式	こうしき	koushiki	formula; formality; official
口実	こうじつ	koujitsu	excuse
	こうして	koushite	thus
校舎	こうしゃ	kousha	school building
公衆	こうしゅう	koushuu	the public
香水	こうすい	kousui	perfume
公正	こうせい	kousei	justice; fairness; impartiality
功績	こうせき	kouseki	achievements; merit; meritorious service; meritorious deed
光線	こうせん	kousen	beam; light ray
高層	こうそう	kousou	upper
構造	こうぞう	kouzou	structure; construction
交替	こうたい	koutai	alternation; change; relief; relay; shift
耕地	こうち	kouchi	arable land
交通機関	こうつうきかん	koutsuukikan	transportation facilities
校庭	こうてい	koutei	campus
肯定	こうてい	koutei	positive; affirmation
高度	こうど	koudo	altitude; height; advanced
高等	こうとう	koutou	high class; high grade
合同	ごうどう	goudou	combination; incorporation; union; amalgamation
後輩	こうはい	kouhai	junior (at work or school)
公表	こうひょう	kouhyou	official announcement; proclamation
鉱物	こうぶつ	koubutsu	mineral
公務	こうむ	koumu	official business; public business
項目	こうもく	koumoku	item
紅葉	こうよう	kouyou	(1) (Japanese) maple
合理	ごうり	gouri	rational
交流	こうりゅう	kouryuu	alternating current; intercourse; (cultural) exchange; intermingling
合流	ごうりゅう	gouryuu	confluence; union; linking up; merge
効力	こうりょく	kouryoku	effect; efficacy; validity; potency
超える	こえる	koeru	to exceed; to cross over; to cross
	コース	koosu	course
	コーラス	koorasu	chorus
焦がす	こがす	kogasu	to burn; to scorch; to singe; to char
国王	こくおう	kokuou	king
国籍	こくせき	kokuseki	nationality
国立	こくりつ	kokuritsu	national
	ごくろうさま	gokurousama	Thank you very much for your....
焦げる	こげる	kogeru	to burn; to be burned
凍える	こごえる	kogoeru	to freeze; to be chilled; to be frozen
心当たり	こころあたり	kokoroatari	having some knowledge of; happening to know
心得る	こころえる	kokoroeru	to be informed; to have thorough knowledge
腰掛け	こしかけ	koshikake	seat; bench
腰掛ける	こしかける	koshikakeru	to sit (down)
五十音	ごじゅうおん	gojuuon	the Japanese syllabary
胡椒	こしょう	koshou	pepper
	こしらえる	koshiraeru	to make; to manufacture
超す	こす	kosu	to cross; to pass; to tide over
擦る	こする	kosuru	to rub; to chafe; to file; to frost (glass); to strike (match)
	ごぞんじですか	gozonjidesuka	(hon) do you know that
個体	こたい	kotai	an individual
御馳走	ごちそう	gochisou	feast; treating (someone)
	ごちそうさま	gochisousama	feast
	こちらこそ	kochirakoso	it is I who should say so
小遣い	こづかい	kozukai	personal expenses; pocket money; spending money; incidental expenses; allowance
	コック	kokku	(1) cook (nl:); (2) tap; spigot; faucet; cock
	こっそり	kossori	stealthily; secretly
古典	こてん	koten	old book; classics; classic
琴	こと	koto	Koto (Japanese harp)
言付ける	ことづける	kotozukeru	to send word; to send a message
言葉遣い	ことばづかい	kotobazukai	speech; expression; wording
	こないだ	konaida	the other day; lately; recently
御無沙汰	ごぶさた	gobusata	not writing or contacting for a while
	こぼす	kobosu	to spill
	こぼれる	koboreru	to overflow; to spill
塵芥	ごみ	gomi	trash; rubbish
	ゴム	gomu	gum; rubber; eraser
御免	ごめん	gomen	your pardon; declining (something); dismissal; permission
	ごめんください	gomenkudasai	May I come in?
小指	こゆび	koyubi	little finger
	こらえる	koraeru	to bear; to stand; to endure; to put up with
娯楽	ごらく	goraku	pleasure; amusement
御覧	ごらん	goran	(hon) look; inspection; try
	コレクション	korekushon	(1) collection; (2) correction
転がす	ころがす	korogasu	to roll
転がる	ころがる	korogaru	to roll; to tumble
紺	こん	kon	navy blue; deep blue
	コンクール	konkuuru	contest (fr: concours)
	コンクリート	konkuriito	concrete
混合	こんごう	kongou	mixing; mixture
	コンセント	konsento	(1) consent; (2) concentric
献立	こんだて	kondate	menu; program; schedule
	こんばんは	konbanha	good evening
	サークル	saakuru	circle; sports club (i.e. at a company)
在学	ざいがく	zaigaku	(enrolled) in school
再三	さいさん	saisan	again and again; repeatedly
祭日	さいじつ	saijitsu	national holiday; festival day
催促	さいそく	saisoku	request; demand; claim; urge (action); press for
採点	さいてん	saiten	marking; grading; looking over
災難	さいなん	sainan	calamity; misfortune
裁縫	さいほう	saihou	sewing
材木	ざいもく	zaimoku	lumber; timber
	サイレン	sairen	siren
逆さ	さかさ	sakasa	reverse; inversion; upside down
逆様	さかさま	sakasama	inversion; upside down
捜す	さがす	sagasu	to search; to seek; to look for
遡る	さかのぼる	sakanoboru	to go back; to go upstream; to make retroactive
酒場	さかば	sakaba	bar; bar-room
	さきおととい	sakiototoi	two days before yesterday
先程	さきほど	sakihodo	some time ago
裂く	さく	saku	to tear; to split
索引	さくいん	sakuin	index; indices
作者	さくしゃ	sakusha	author; authoress
削除	さくじょ	sakujo	elimination; cancellation; deletion; erasure
作成	さくせい	sakusei	frame; draw up; make; producing
作製	さくせい	sakusei	manufacture
探る	さぐる	saguru	to search; to look for; to sound out
囁く	ささやく	sasayaku	to whisper; to murmur
刺さる	ささる	sasaru	to stick; to be stuck
匙	さじ	saji	spoon
座敷	ざしき	zashiki	tatami room
差し支え	さしつかえ	sashitsukae	hindrance; impediment
差し引き	さしひき	sashihiki	deduction; subtraction; balance; ebb and flow; rise and fall
刺身	さしみ	sashimi	sliced raw fish
刺す	さす	sasu	to pierce; to stab; to prick; to thrust
挿す	さす	sasu	to insert; to put in; to graft; to wear in belt
注す	さす	sasu	to pour (drink); to serve (drinks)
射す	さす	sasu	to shine; to strike
流石	さすが	sasuga	clever; adept; good; expectations; as one would expect
撮影	さつえい	satsuei	photographing
雑音	ざつおん	zatsuon	noise (jarring; grating)
	さっさと	sassato	quickly
早速	さっそく	sassoku	at once; immediately; without delay; promptly
錆	さび	sabi	rust (colour)
錆びる	さびる	sabiru	to rust; to become rusty
座布団	ざぶとん	zabuton	cushion (Japanese)
冷ます	さます	samasu	to cool; to dampen; to let cool
妨げる	さまたげる	samatageru	to disturb; to prevent
冷める	さめる	sameru	to become cool; to wear off; to abate; to subside
再来月	さらいげつ	saraigetsu	month after next
再来週	さらいしゅう	saraishuu	week after next
再来年	さらいねん	sarainen	year after next
	サラリーマン	sarariiman	salary man; company employee
騒がしい	さわがしい	sawagashii	noisy
	さわやか	sawayaka	fresh; refreshing; invigorating
三角	さんかく	sankaku	triangle; triangular
算数	さんすう	sansuu	arithmetic
酸性	さんせい	sansei	acidity
産地	さんち	sanchi	producing area
	サンプル	sanpuru	sample
山林	さんりん	sanrin	mountain forest; mountains and forest
仕上がる	しあがる	shiagaru	to be finished
	しあさって	shiasatte	two days after tomorrow
	シーズン	shiizun	season (sporting)
	シーツ	shiitsu	sheet
寺院	じいん	jiin	temple
	しいんと（する）	shin(suru)	silent (as the grave); (deathly) quiet
自衛	じえい	jiei	self-defense
塩辛い	しおからい	shiokarai	salty (taste)
司会	しかい	shikai	chairmanship
四角	しかく	shikaku	square
四角い	しかくい	shikakui	square
時間割	じかんわり	jikanwari	timetable; schedule
四季	しき	shiki	four seasons
敷地	しきち	shikichi	site
至急	しきゅう	shikyuu	urgent; pressing
敷く	しく	shiku	to spread out; to lay out
茂る	しげる	shigeru	to grow thick; to luxuriate; to be luxurious
持参	じさん	jisan	bringing; taking; carrying
磁石	じしゃく	jishaku	magnet
四捨五入	ししゃごにゅう	shishagonyuu	rounding up (fractions)
始終	しじゅう	shijuu	continuously; from beginning to end
自習	じしゅう	jishuu	self-study
静まる	しずまる	shizumaru	to quieten down; to calm down; to subside
姿勢	しせい	shisei	attitude; posture
自然科学	しぜんかがく	shizenkagaku	natural science
時速	じそく	jisoku	speed (per hour)
子孫	しそん	shison	descendants; posterity; offspring
死体	したい	shitai	corpse
下書き	したがき	shitagaki	rough copy; draft
下町	したまち	shitamachi	Shitamachi; lower parts of town
自治	じち	jichi	self-government; autonomy
実感	じっかん	jikkan	feelings (actual; true)
湿気	しっけ/しっき	shikke/shikki	moisture; humidity; dampness
	しつこい	shitsukoi	insistent; obstinate
実習	じっしゅう	jisshuu	practice; training
実績	じっせき	jisseki	achievements; actual results
湿度	しつど	shitsudo	level of humidity
執筆	しっぴつ	shippitsu	writing
実物	じつぶつ	jitsubutsu	real thing; original
	しっぽ	shippo	tail (animal)
実用	じつよう	jitsuyou	practical use; utility
実力	じつりょく	jitsuryoku	merit; efficiency; arms; force
実例	じつれい	jitsurei	example; illustration
失恋	しつれん	shitsuren	disappointed love; broken heart; unrequited love; be lovelorn
指定	してい	shitei	designation; specification; assignment; pointing at
私鉄	してつ	shitetsu	private railway
児童	じどう	jidou	children; juvenile
縛る	しばる	shibaru	to tie; to bind
地盤	じばん	jiban	(the) ground
	しびれる	shibireru	to become numb; to go to sleep (i.e.; a limb)
紙幣	しへい	shihei	paper money; notes; bills
	しぼむ	shibomu	to wither; to fade (away); to shrivel; to wilt
絞る	しぼる	shiboru	to press; to wring; to squeeze
縞	しま	shima	stripe
地味	じみ	jimi	plain; simple
	しみじみ	shimijimi	keenly; deeply; heartily
氏名	しめい	shimei	full name; identity
締切り	しめきり	shimekiri	closing; cut-off; end; deadline; Closed; No Entrance
締め切る	しめきる	shimekiru	to shut up
湿る	しめる	shimeru	to be wet; to become wet; to be damp
	ジャーナリスト	jaanarisuto	journalist
社会科学	しゃかいかがく	shakaikagaku	social science
	しゃがむ	shagamu	to squat
蛇口	じゃぐち	jaguchi	faucet; tap
弱点	じゃくてん	jakuten	weak point; weakness
車庫	しゃこ	shako	garage; car shed
車掌	しゃしょう	shashou	(train) conductor
写生	しゃせい	shasei	sketching; drawing from nature
社説	しゃせつ	shasetsu	editorial; leading article
	しゃっくり	shakkuri	hiccough; hiccup
	シャッター	shattaa	shutter
	しゃぶる	shaburu	to suck; to chew
車輪	しゃりん	sharin	(car) wheel
洒落	しゃれ	share	joke; pun; witticism
	じゃんけん	janken	(n) rock-scissors-paper game
集会	しゅうかい	shuukai	meeting; assembly
住居	じゅうきょ	juukyo	dwelling; house; residence; address
集金	しゅうきん	shuukin	money collection
集合	しゅうごう	shuugou	gathering; assembly; meeting; set (math)
習字	しゅうじ	shuuji	penmanship
修繕	しゅうぜん	shuuzen	repair; mending
重体	じゅうたい	juutai	seriously ill; serious condition; critical state
	じゅうたん/カーペット	juutan/kaapetto	carpet
終点	しゅうてん	shuuten	terminus; last stop (e.g train)
重点	じゅうてん	juuten	important point; lay stress on; colon; emphasis
就任	しゅうにん	shuunin	inauguration; assumption of office
周辺	しゅうへん	shuuhen	circumference; outskirts; environs; (computer) peripheral
重役	じゅうやく	juuyaku	director; high executive
終了	しゅうりょう	shuuryou	end; close; termination
重量	じゅうりょう	juuryou	(1) weight; (2) heavyweight boxer
重力	じゅうりょく	juuryoku	gravity
熟語	じゅくご	jukugo	idiom; idiomatic phrase; kanji compound
祝日	しゅくじつ	shukujitsu	national holiday
縮小	しゅくしょう	shukushou	reduction; curtailment
受験	じゅけん	juken	taking an examination
主語	しゅご	shugo	(gram) subject
出勤	しゅっきん	shukkin	going to work; at work
述語	じゅつご	jutsugo	predicate
出張	しゅっちょう	shucchou	official tour; business trip
寿命	じゅみょう	jumyou	life span
主役	しゅやく	shuyaku	leading part; leading actor (actress)
受話器	じゅわき	juwaki	(telephone) receiver
循環	じゅんかん	junkan	circulation; rotation; cycle
巡査	じゅんさ	junsa	police; policeman
順々	じゅんじゅん	junjun	in order; in turn
順序	じゅんじょ	junjo	order; sequence; procedure
純情	じゅんじょう	junjou	pure heart; naivete; self-sacrificing devotion
純粋	じゅんすい	junsui	pure; true; genuine; unmixed
消化	しょうか	shouka	digestion
小学生	しょうがくせい	shougakusei	grade school student
	しょうがない	shouganai	nothing can be made
将棋	しょうぎ	shougi	Japanese chess
蒸気	じょうき	jouki	steam; vapour
定規	じょうぎ	jougi	(measuring) ruler
上級	じょうきゅう	joukyuu	advanced level; high grade; senior
商業	しょうぎょう	shougyou	commerce; trade; business
消極的	しょうきょくてき	shoukyokuteki	passive
賞金	しょうきん	shoukin	prize; monetary award
上下	じょうげ	jouge	high and low; up and down; unloading and loading; praising and blaming
障子	しょうじ	shouji	paper sliding door
商社	しょうしゃ	shousha	trading company; firm
乗車	じょうしゃ	jousha	taking a train; entraining
上旬	じょうじゅん	joujun	first 10 days of month
生ずる	しょうずる	shouzuru	to cause; to arise; to be generated
小数	しょうすう	shousuu	fraction (part of); decimal
商店	しょうてん	shouten	shop; business firm
焦点	しょうてん	shouten	focus; point
消毒	しょうどく	shoudoku	disinfection; sterilization
勝敗	しょうはい	shouhai	victory or defeat; issue (of battle)
蒸発	じょうはつ	jouhatsu	evaporation; unexplained disappearance
賞品	しょうひん	shouhin	prize; trophy
勝負	しょうぶ	shoubu	victory or defeat; match; contest; game; bout
小便	しょうべん	shouben	(col) urine; piss
消防署	しょうぼうしょ	shoubousho	fire station
正味	しょうみ	shoumi	net (weight)
正面	しょうめん	shoumen	the front; honesty
消耗	しょうもう	shoumou	exhaustion; consumption
醤油	しょうゆ	shouyu	soy sauce
省略	しょうりゃく	shouryaku	omission; abbreviation; abridgment
初級	しょきゅう	shokyuu	elementary level
助教授	じょきょうじゅ	jokyouju	assistant professor
食塩	しょくえん	shokuen	table salt
職人	しょくにん	shokunin	worker; mechanic; artisan; craftsman
初旬	しょじゅん	shojun	first 10 days of the month
書籍	しょせき	shoseki	book; publication
食器	しょっき	shokki	tableware
	ショップ	shoppu	a shop
書店	しょてん	shoten	bookshop
書道	しょどう	shodou	calligraphy
白髪	しらが	shiraga	white or grey hair; trendy hair bleaching
知合い	しりあい	shiriai	acquaintance
	シリーズ	shiriizu	series
私立	しりつ	shiritsu	private (establishment)
資料	しりょう	shiryou	materials; data
汁	しる	shiru	juice; sap; soup; broth
素人	しろうと	shirouto	amateur; novice
芯	しん	shin	core; heart; wick; marrow
新幹線	しんかんせん	shinkansen	bullet train (very high speed); shinkansen
真空	しんくう	shinkuu	vacuum; hollow; empty
信ずる	しんずる	shinzuru	to believe; to believe in; to place trust in
心身	しんしん	shinshin	mind and body
申請	しんせい	shinsei	application; request; petition
人造	じんぞう	jinzou	man-made; synthetic; artificial
寝台	しんだい	shindai	bed; couch
診断	しんだん	shindan	diagnosis
侵入	しんにゅう	shinnyuu	penetration; invasion; raid; aggression; trespass
人文科学	じんぶんかがく	jinbunkagaku	social sciences; humanities
人命	じんめい	jinmei	(human) life
深夜	しんや	shinya	late at night
森林	しんりん	shinrin	forest; woods
親類	しんるい	shinrui	relation; kin
針路	しんろ	shinro	course; direction; compass bearing
神話	しんわ	shinwa	myth; legend
酢	す	su	vinegar
水産	すいさん	suisan	marine products; fisheries
炊事	すいじ	suiji	cooking; culinary arts
水蒸気	すいじょうき	suijouki	water vapour; steam
水素	すいそ	suiso	hydrogen
垂直	すいちょく	suichoku	vertical; perpendicular
推定	すいてい	suitei	presumption; assumption; estimation
水滴	すいてき	suiteki	drop of water
水筒	すいとう	suitou	canteen; flask; water bottle
随筆	ずいひつ	zuihitsu	essays; miscellaneous writings
水分	すいぶん	suibun	moisture
水平	すいへい	suihei	water level; horizon
水平線	すいへいせん	suiheisen	horizon
水曜	すいよう	suiyou	Wednesday
	ずうずうしい	zuuzuushii	impudent; shameless
	ずうっと	zuutto	all the time; all along; right down; straight on; all the way
末っ子	すえっこ	suekko	youngest child
	スカーフ	sukaafu	scarf
図鑑	ずかん	zukan	picture book
杉	すぎ	sugi	Japanese cedar
好き嫌い	すききらい	sukikirai	likes and dislikes; taste
好き好き	すきずき	sukizuki	matter of taste
透き通る	すきとおる	sukitooru	to be(come) transparent
隙間	すきま	sukima	crevice; crack; gap; opening
	スクール	sukuuru	school
	すくなくとも	sukunakutomo	at least
図形	ずけい	zukei	figure
	スケジュール	sukejuuru	schedule
鈴	すず	suzu	bell
涼む	すずむ	suzumu	to cool oneself; to cool off; to enjoy evening cool
	スタート	sutaato	start
	スチュワーデス	suchuwaadesu	stewardess
	すっきり	sukkiri	shapely; clear; neat
	すっぱい	suppai	sour; acid
	ステージ	suteeji	(1) stage; (2) performance
棄てる	すてる	suteru	throw away
	ストッキング	sutokkingu	stockings
	ストップ	sutoppu	stop
素直	すなお	sunao	obedient; meek; docile; unaffected
頭脳	ずのう	zunou	head; brains; intellect
	スピーカー	supiikaa	speaker
図表	ずひょう	zuhyou	chart; diagram; graph
	スマート	sumaato	smart; stylish; slim
住まい	すまい	sumai	dwelling; house; residence; address
	すまない	sumanai	sorry (phrase)
墨	すみ	sumi	ink
澄む(清む)	すむ	sumu	to clear (e.g. weather); to become transparent
相撲	すもう	sumou	sumo wrestling
	スライド	suraido	slide
	ずらす	zurasu	to put off; to delay
	ずらり	zurari	in a row
掏摸	すり	suri	pickpocket
刷る	する	suru	to print
狡い	ずるい	zurui	sly; cunning
	すれちがう	surechigau	to pass by one another; to disagree
滑れる	ずれる	zureru	slidable
寸法	すんぽう	sunpou	measurement; size; dimension
姓	せい	sei	surname; family name
税関	ぜいかん	zeikan	customs house
製作	せいさく	seisaku	manufacture; production
制作	せいさく	seisaku	work (film; book)
性質	せいしつ	seishitsu	nature; property; disposition
清書	せいしょ	seisho	clean copy
青少年	せいしょうねん	seishounen	youth; young person
整数	せいすう	seisuu	integer
清掃	せいそう	seisou	cleaning
生存	せいぞん	seizon	existence; being; survival
生長	せいちょう	seichou	growth; increment
政党	せいとう	seitou	(member of) political party
生年月日	せいねんがっぴ	seinengappi	birth date
性能	せいのう	seinou	ability; efficiency
整備	せいび	seibi	adjustment; completion; consolidation
成分	せいぶん	seibun	ingredient; component; composition
性別	せいべつ	seibetsu	distinction by sex; sex; gender
正方形	せいほうけい	seihoukei	square
正門	せいもん	seimon	main gate; main entrance
成立	せいりつ	seiritsu	coming into existence; arrangements; establishment; completion
西暦	せいれき	seireki	Christian Era; anno domini (A.D.)
背負う	せおう	seou	to be burdened with; to carry on back or shoulder
赤道	せきどう	sekidou	equator
折角	せっかく	sekkaku	with trouble; at great pains; long-awaited
接近	せっきん	sekkin	getting closer; drawing nearer; approaching
石鹸	せっけん	sekken	soap
接する	せっする	sessuru	to come in contact with; to connect; to attend; to receive
	せっせと	sesseto	hard; diligently; assiduously
接続	せつぞく	setsuzoku	(1) connection; union; join; link; (2) changing trains
瀬戸物	せともの	setomono	earthenware; crockery; china
	ぜひとも	zehitomo	by all means (with sense of not taking no for an answer)
迫る	せまる	semaru	to draw near; to press
	ゼミ	zemi	(n) seminar
	せめて	semete	offense; method of attack
攻める	せめる	semeru	to attack; to assault
	セメント	semento	cement
栓	せん	sen	stopper; cork; stopcock
前後	ぜんご	zengo	around; throughout; front and back; before and behind; before and after
洗剤	せんざい	senzai	detergent; washing material
全集	ぜんしゅう	zenshuu	complete works
全身	ぜんしん	zenshin	the whole body; full-length (portrait)
扇子	せんす	sensu	folding fan
専制	せんせい	sensei	despotism; autocracy
先々月	せんせんげつ	sensengetsu	month before last
先々週	せんせんしゅう	sensenshuu	week before last
先祖	せんぞ	senzo	ancestor
先端	せんたん	sentan	pointed end; tip; fine point
	センチ	senchi	centimeter; centi-; 10^-2
宣伝	せんでん	senden	propaganda; publicity
先頭	せんとう	sentou	head; lead; vanguard; first
全般	ぜんぱん	zenpan	(the) whole; universal; wholly; general
扇風機	せんぷうき	senpuuki	electric fan
線路	せんろ	senro	line; track; roadbed
相違	そうい	soui	difference; discrepancy; variation
	そういえば	souieba	which reminds me ..
雑巾	ぞうきん	zoukin	house-cloth; dust cloth
増減	ぞうげん	zougen	increase and decrease; fluctuation
倉庫	そうこ	souko	storehouse; warehouse; godown
相互	そうご	sougo	mutual; reciprocal
創作	そうさく	sousaku	production; literary creation; work
葬式	そうしき	soushiki	funeral
	そうして	soushite	and; like that
造船	ぞうせん	zousen	shipbuilding
騒々しい	そうぞうしい	souzoushii	noisy; boisterous
増大	ぞうだい	zoudai	enlargement
	そうっと	soutto	softly; gently; quietly; secretly
送別	そうべつ	soubetsu	farewell; send-off
草履	ぞうり	zouri	zoori (Japanese footwear); sandals
総理大臣	そうりだいじん	souridaijin	Prime Minister
送料	そうりょう	souryou	postage; carriage
属する	ぞくする	zokusuru	to belong to; to come under; to be affiliated with; to be subject to
続々	ぞくぞく	zokuzoku	successively; one after another
速達	そくたつ	sokutatsu	express; special delivery
測定	そくてい	sokutei	measurement
測量	そくりょう	sokuryou	measurement; surveying
速力	そくりょく	sokuryoku	speed
素質	そしつ	soshitsu	character; qualities; genius
祖先	そせん	sosen	ancestor
	そそっかしい	sosokkashii	careless; thoughtless
卒直	そっちょく	socchoku	frankness; candour; openheartedness
具える	そなえる	sonaeru	to be furnished with
	そのうえ	sonoue	in addition; furthermore
	そのころ	sonokoro	then; in those days
	そのため	sonotame	hence; for that reason
	そのほか	sonohoka	otherwise
蕎麦	そば	soba	soba (buckwheat noodles)
剃る	そる	soru	to shave
	それなのに	sorenanoni	but
逸れる	それる	soreru	to stray (turn) from subject; to get lost; to go astray
揃う	そろう	sorou	to become complete; to be equal; to be all present; to gather
揃える	そろえる	soroeru	to put things in order; to arrange; to make uniform; to get something ready
算盤	そろばん	soroban	abacus
存じる/存ずる	ぞんじる/ぞんずる	zonjiru/ zonzuru	(hum) to know
損得	そんとく	sontoku	loss and gain; advantage and disadvantage
田ぼ	たんぼ	tanbo	paddy field; farm
第一	だいいち	daiiichi	first; foremost; # 1
退院	たいいん	taiin	leaving hospital
大学院	だいがくいん	daigakuin	graduate school
大工	だいく	daiku	carpenter
体系	たいけい	taikei	system; organization
太鼓	たいこ	taiko	drum; tambourine
対策	たいさく	taisaku	counter-plan; counter-measure
大して	たいして	taishite	(not so) much; (not) very
対照	たいしょう	taishou	contrast; antithesis; comparison
大小	だいしょう	daishou	size
体制	たいせい	taisei	order; system; structure; set-up; organization
体積	たいせき	taiseki	capacity; volume
大層	たいそう	taisou	very much; exaggerated; very fine
体操	たいそう	taisou	gymnastics; physical exercises; calisthenics
大分	だいぶん	daibun	considerably; greatly; a lot
大木	たいぼく	taiboku	large tree
題名	だいめい	daimei	title
代名詞	だいめいし	daimeishi	pronoun
	タイア	taia	tire; tyre
	ダイヤグラム	daiyaguramu	diagram
	ダイヤモンド	daiyamondo	diamond
	ダイヤル	daiyaru	dial
対立	たいりつ	tairitsu	confrontation; opposition; antagonism
田植え	たうえ	taue	rice planting
絶えず	たえず	taezu	constantly
楕円	だえん	daen	ellipse
高める	たかめる	takameru	to raise; to lift; to boost
耕す	たがやす	tagayasu	to till; to plow; to cultivate
滝	たき	taki	waterfall
炊く	たく	taku	to boil; to cook
焚く	たく	taku	to burn; to kindle; to build a fire
蓄える	たくわえる	takuwaeru	to store; to lay in stock
竹	たけ	take	bamboo; middle (of a three-tier ranking system)
助かる	たすかる	tasukaru	to be saved; to be rescued; to survive; to be helpful
只	ただ	tada	free of charge; mere; sole; only; usual; common
但し	ただし	tadashi	but; however; provided that
畳む	たたむ	tatamu	to fold (clothes)
立ち止まる	たちどまる	tachidomaru	to stop; to halt; to stand still
	たちまち	tachimachi	at once; in a moment; suddenly; all at once
建つ	たつ	tatsu	to erect; to be erected; to be built
発つ	たつ	tatsu	to depart (on a plane; train; etc.)
脱線	だっせん	dassen	derailment; digression
妥当	だとう	datou	valid; proper; right; appropriate
例える	たとえる	tatoeru	to compare; to liken; to speak figuratively; to illustrate; to use a simile
頼もしい	たのもしい	tanomoshii	reliable; trustworthy; hopeful; promising
足袋	たび	tabi	tabi; Japanese socks (with split toe)
	ダブル	daburu	double
	だます	damasu	to trick; to cheat; to deceive
溜まる	たまる	tamaru	to collect; to gather; to save
	ダム	damu	dumb
溜息	ためいき	tameiki	a sigh
	ためらう	tamerau	to hesitate
溜める	ためる	tameru	to amass; to accumulate
	だらしない	darashinai	slovenly; loose; a slut
足る	たる	taru	to be sufficient; to be enough
段階	だんかい	dankai	gradation; grade; stage
短期	たんき	tanki	short term
炭鉱	たんこう	tankou	coal mine; coal pit
短所	たんしょ	tansho	(1) defect; demerit; weak point; (2) disadvantage
	たんす	tansu	chest of drawers
淡水	たんすい	tansui	fresh water
断水	だんすい	dansui	water outage
単数	たんすう	tansuu	singular (number)
団地	だんち	danchi	multi-unit apartments
断定	だんてい	dantei	conclusion; decision
短編	たんぺん	tanpen	short (e.g. story; film)
誓う	ちかう	chikau	to swear; to vow; to take an oath; to pledge
地下水	ちかすい	chikasui	underground water
近々	ちかぢか	chikajika	nearness; before long
近付ける	ちかづける	chikazukeru	to bring near; to put close; to let come near; to associate with
近寄る	ちかよる	chikayoru	to approach; to draw near
力強い	ちからづよい	chikarazuyoi	reassuring; emboldened
	ちぎる	chigiru	to cut up fine; to pick (fruit)
地質	ちしつ	chishitsu	geological features
知人	ちじん	chijin	friend; acquaintance
地帯	ちたい	chitai	area; zone
縮む	ちぢむ	chijimu	to shrink; to be contracted
縮める	ちぢめる	chijimeru	to shorten; to reduce; to boil down; to shrink
縮れる	ちぢれる	chijireru	to be wavy; to be curled
	チップ	chippu	(1) gratuity; tip; (2) chip
地点	ちてん	chiten	site; point on a map
地名	ちめい	chimei	place name
茶色い	ちゃいろい	chairoi	brown
着々	ちゃくちゃく	chakuchaku	steadily
茶碗	ちゃわん	chawan	rice bowl; tea cup; teacup
中間	ちゅうかん	chuukan	middle; midway; interim
中旬	ちゅうじゅん	chuujun	second third of a month
抽象	ちゅうしょう	chuushou	abstract
中世	ちゅうせい	chuusei	Middle Ages; mediaeval times
中性	ちゅうせい	chuusei	neuter gender; neutral (chem.); indifference; sterility
中途	ちゅうと	chuuto	in the middle; half-way
中年	ちゅうねん	chuunen	middle-aged
超過	ちょうか	chouka	excess; being more than
彫刻	ちょうこく	choukoku	carving; engraving; sculpture
長所	ちょうしょ	chousho	(1) strong point; merit; (2) advantage
長女	ちょうじょ	choujo	eldest daughter
調整	ちょうせい	chousei	regulation; adjustment; tuning
調節	ちょうせつ	chousetsu	regulation; adjustment; control
長短	ちょうたん	choutan	length; long and short; +-
頂点	ちょうてん	chouten	top; summit
長男	ちょうなん	chounan	eldest son
長方形	ちょうほうけい	chouhoukei	rectangle; oblong
調味料	ちょうみりょう	choumiryou	condiment; seasoning
	チョーク	chooku	chock; chalk
直後	ちょくご	chokugo	immediately following
直線	ちょくせん	chokusen	straight line
直前	ちょくぜん	chokuzen	just before
直通	ちょくつう	chokutsuu	direct communication
直流	ちょくりゅう	chokuryuu	direct current
貯蔵	ちょぞう	chozou	storage; preservation
直角	ちょっかく	chokkaku	right angle
直径	ちょっけい	chokkei	diameter
散らかす	ちらかす	chirakasu	to scatter around; to leave untidy
散らかる	ちらかる	chirakaru	to be in disorder; to lie scattered around
散らす	ちらす	chirasu	to scatter; to disperse; to distribute
塵紙	ちりがみ	chirigami	tissue paper; toilet paper
散る	ちる	chiru	to fall; to scatter (e.g. blossoms)
追加	ついか	tsuika	addition; supplement; appendix
	ついで	tsuide	opportunity; occasion
通貨	つうか	tsuuka	currency
通勤	つうきん	tsuukin	commuting to work
通ずる	つうずる	tsuuzuru	to be open (to traffic); to lead to; to communicate (with); to flow; to pass; to get through to; to be understood; to be honored; to form a liaison
通知	つうち	tsuuchi	notice; notification
通帳	つうちょう	tsuuchou	passbook
通訳	つうやく	tsuuyaku	interpretation
通用	つうよう	tsuuyou	popular use; circulation
通路	つうろ	tsuuro	passage; pathway
付合う	つきあう	tsukiau	to associate with; to keep company with; to get on with
突き当たり	つきあたり	tsukiatari	end (e.g. of street)
突き当たる	つきあたる	tsukiataru	to run into; to collide with
月日	つきひ	tsukihi	time; years; days
点く	つく	tsuku	to catch fire; (electricity) comes on
突く	つく	tsuku	(1) to thrust; to strike; (2) to poke
次ぐ	つぐ	tsugu	to rank next to; to come after
作る/造る	つくる	tsukuru	to make; to create
着ける	つける	tsukeru	(1) to attach; to join; to add; to append
点ける	つける	tsukeru	to turn on; to switch on; to light up
浸ける	つける	tsukeru	to dip in; to soak
伝わる	つたわる	tsutawaru	to be handed down; to be introduced; to be transmitted
突っ込む	つっこむ	tsukkomu	to plunge into; to go into deeply
務める	つとめる	tsutomeru	(1) to serve; to fill a post; to serve under; to work (for)
綱	つな	tsuna	rope
繋がり	つながり	tsunagari	connection; link; relationship
繋がる	つながる	tsunagaru	to be tied together; to be connected to; to be related to
繋げる	つなげる	tsunageru	to connect
粒	つぶ	tsubu	grain
潰す	つぶす	tsubusu	to smash; to waste
潰れる	つぶれる	tsubureru	to be smashed; to go bankrupt
	つまずく	tsumazuku	to stumble; to trip
詰まる	つまる	tsumaru	to be blocked; to be packed
積む	つむ	tsumu	to pile up; to stack
爪	つめ	tsume	fingernail or toenail; claw; talon; hoof
艶	つや	tsuya	gloss; glaze
強気	つよき	tsuyoki	firm; strong
釣り合う	つりあう	tsuriau	to balance; to be in harmony; to suit
吊る/吊す	つる/つるす	tsuru/ tsurusu	to hang
出合い	であい	deai	an encounter
手洗い	てあらい	tearai	restroom; lavatory; hand-washing
定員	ていいん	teiin	fixed number of regular personnel; capacity (of boat; etc.)
定価	ていか	teika	established price
低下	ていか	teika	fall; decline; lowering; deterioration
定期券	ていきけん	teikiken	commuter pass; season ticket
定休日	ていきゅうび	teikyuubi	regular holiday
停止	ていし	teishi	suspension; interruption; stoppage; ban
停車	ていしゃ	teisha	stopping (e.g. train)
停電	ていでん	teiden	failure of electricity
出入り	でいり	deiri	in and out; coming and going; free association; income and expenditure; debits and credit
出入口	でいりぐち	deiriguchi	exit and entrance
手入れ	ていれ	teire	repairs; maintenance
	テーマ	teema	(n) theme; project; topic (de: Thema)
出掛ける	でかける	dekakeru	to depart; to set out; to start; to be going out
出来上がり	できあがり	dekiagari	be finished; ready; made for; cut out
出来上がる	できあがる	dekiagaru	(1) to be finished; to be ready; by definition; (2) to be very drunk
的確/適確	てきかく	tekikaku	precise; accurate
手首	てくび	tekubi	wrist
凸凹	でこぼこ	dekoboko	unevenness; roughness; ruggedness
手頃	てごろ	tegoro	moderate; handy
	でたらめ	detarame	(1) irresponsible utterance; nonsense; nonsensical; (2) random
手帳	てちょう	techou	notebook
鉄橋	てっきょう	tekkyou	railway bridge; iron bridge
手続き	てつづき	tetsuzuki	procedure; (legal) process; formalities
鉄砲	てっぽう	teppou	gun
	テニスコート	tenisukooto	tennis court
手拭い	てぬぐい	tenugui	(hand) towel
手前	てまえ	temae	before; this side; we; you
出迎え	でむかえ	demukae	meeting; reception
出迎える	でむかえる	demukaeru	to meet; to greet
照らす	てらす	terasu	to shine on; to illuminate
照る	てる	teru	to shine
展開	てんかい	tenkai	develop; expansion (opposite of compression)
伝記	でんき	denki	biography; life story
電球	でんきゅう	denkyuu	light bulb
点数	てんすう	tensuu	marks; points; score; runs
伝染	でんせん	densen	contagion
電池	でんち	denchi	battery
点々	てんてん	tenten	here and there; little by little
転々	てんてん	tenten	moving from place to place; being passed around repeatedly
電柱	でんちゅう	denchuu	telephone pole; telegraph pole; lightpole
天皇	てんのう	tennou	Emperor of Japan
電波	でんぱ	denpa	electro-magnetic wave
	テンポ	tenpo	tempo
電流	でんりゅう	denryuu	electric current
電力	でんりょく	denryoku	electric power
問い合わせ	といあわせ	toiawase	enquiry; ENQ
銅	どう	dou	copper
統一	とういつ	touitsu	unity; consolidation; uniformity
同格	どうかく	doukaku	the same rank; equality; apposition
峠	とうげ	touge	ridge; (mountain) pass; difficult part
統計	とうけい	toukei	scattering; a scatter; dispersion
動作	どうさ	dousa	action; movements; motions; bearing; behaviour; manners
東西	とうざい	touzai	East and West; whole country
当日	とうじつ	toujitsu	appointed day; very day
投書	とうしょ	tousho	letter to the editor; letter from a reader; contribution
登場	とうじょう	toujou	entry (on stage)
	どうせ	douse	anyhow; in any case; at any rate
	どうぞよろしく	douzoyoroshiku	pleased to meet you
灯台	とうだい	toudai	lighthouse
盗難	とうなん	tounan	theft; robbery
当番	とうばん	touban	being on duty
等分	とうぶん	toubun	division into equal parts
透明	とうめい	toumei	transparency; cleanness
灯油	とうゆ	touyu	lamp oil; kerosene
東洋	とうよう	touyou	Orient
童話	どうわ	douwa	fairy tale
通り掛かる	とおりかかる	toorikakaru	to happen to pass by
溶かす	とかす	tokasu	to melt; to dissolve
尖る	とがる	togaru	to taper to a point; to become sharp; to be sour; to look displeased
	どきどき	dokidoki	throb; beat (fast)
溶く	とく	toku	to dissolve (paint)
退く	どく	doku	(1) to retreat; to recede; to withdraw
特殊	とくしゅ	tokushu	special; unique
特色	とくしょく	tokushoku	characteristic; feature
特長	とくちょう	tokuchou	forte; merit
特定	とくてい	tokutei	specific; special; particular
特売	とくばい	tokubai	special sale
溶け込む	とけこむ	tokekomu	to melt into
溶ける	とける	tokeru	to melt; to thaw; to fuse; to dissolve
退ける	どける	dokeru	to remove; to take away; to dislodge; to put something out of the way
床の間	とこのま	tokonoma	alcove
床屋	とこや	tokoya	barber
所々	ところどころ	tokorodokoro	here and there; some parts (of something)
都心	としん	toshin	heart (of city)
戸棚	とだな	todana	cupboard; locker; closet; wardrobe
	とっくに	tokkuni	long ago; already; a long time ago
	どっと	dotto	suddenly
整う	ととのう	totonou	to be prepared; to be in order; to be put in order; to be arranged
留まる	とどまる	todomaru	(1) to be fixed; (2) to abide; to stay (in the one place)
	どなる	donaru	to shout; to yell
飛び込む	とびこむ	tobikomu	to jump in; to leap in; to plunge into; to dive
跳ぶ	とぶ	tobu	to jump; to fly; to leap
留まる	とまる	tomaru	(1) to be fixed; (2) to abide; to stay (in the one place)
泊める	とめる	tomeru	to give shelter to; to lodge
	ともかく	tomokaku	anyhow; anyway; somehow or other; generally speaking; in any case
捕える	とらえる	toraeru	to seize; to grasp; to capture; to arrest
取り入れる	とりいれる	toriireru	to harvest; to take in; to adopt
取り消す	とりけす	torikesu	to cancel
取り出す	とりだす	toridasu	to take out; to produce; to pick out
採る	とる	toru	(1) to adopt (measure; proposal); (2) to pick (fruit)
捕る	とる	toru	to take; to catch (fish); to capture
	トレーニング	toreeningu	training
丼	どんぶり	donburi	porcelain bowl; bowl of rice with food on top
内科	ないか	naika	internist clinic; internal medicine
内線	ないせん	naisen	phone extension; indoor wiring; inner line
	ナイロン	nairon	nylon
治す	なおす	naosu	to cure; to heal; to fix; to correct; to repair
永い	ながい	nagai	long; lengthy
仲直り	なかなおり	nakanaori	reconciliation; make peace with
長引く	ながびく	nagabiku	to be prolonged; to drag on
中身/中味	なかみ	nakami	contents; interior; substance; filling; (sword) blade
中指	なかゆび	nakayubi	middle finger
仲良し	なかよし	nakayoshi	intimate friend; bosom buddy; chum
慰める	なぐさめる	nagusameru	to comfort; to console
亡くす	なくす	nakusu	to lose someone; wife; child; etc
	なぐる	naguru	to strike; to hit
為す	なす	nasu	to accomplish; to do
謎謎	なぞなぞ	nazonazo	riddle; puzzle; enigma
傾らか	なだらか	nadaraka	gently-sloping; gentle; easy
懐かしい	なつかしい	natsukashii	dear; desired; missed
撫でる	なでる	naderu	to brush gently; to stroke
斜め	ななめ	naname	obliqueness
	なにしろ	nanishiro	at any rate; anyhow; anyway; in any case
何々	なになに	naninani	such and such; What?
何分	なにぶん	nanibun	what minute?; how many minutes?
生意気	なまいき	namaiki	impertinent; saucy; cheeky; conceit; audacious; brazen
並木	なみき	namiki	roadside tree; row of trees
倣う	ならう	narau	to imitate; to follow; to emulate
鳴らす	ならす	narasu	to ring; to sound; to chime; to beat; to snort (nose)
生る	なる	naru	to bear fruit
馴れる	なれる	nareru	to become domesticated; to become tame
南極	なんきょく	nankyoku	south pole; Antarctic
	なんとなく	nantonaku	somehow or other; for some reason or another
	なんとも	nantomo	nothing (with neg. verb); quite; not a bit
	ナンバー	nanbaa	number
南米	なんべい	nanbei	South America
南北	なんぼく	nanboku	south and north
煮える	にえる	nieru	to boil; to cook; to be cooked
匂う	におう	niou	to be fragrant; to smell; to stink
逃がす	にがす	nigasu	to let loose; to set free; to let escape
憎い	にくい	nikui	hateful; abominable; poor-looking; detestable
憎む	にくむ	nikumu	to hate; to detest
憎らしい	にくらしい	nikurashii	odious; hateful
	にこにこ	nikoniko	smilingly; beamingly; with a smile
濁る	にごる	nigoru	to become muddy; to get impure
虹	にじ	niji	rainbow
日時	にちじ	nichiji	date and time
日用品	にちようひん	nichiyouhin	daily necessities
日課	にっか	nikka	daily lesson; daily work; daily routine
日程	にってい	nittei	agenda
鈍い	にぶい	nibui	dull (e.g. a knife); thickheaded; slow (opposite of fast); stupid
入社	にゅうしゃ	nyuusha	entry to a company
女房	にょうぼう	nyoubou	wife
睨む	にらむ	niramu	to glare at; to scowl at; to keep an eye on
煮る	にる	niru	to boil; to cook
俄	にわか	niwaka	sudden; abrupt; unexpected; improvised; offhand
縫う	ぬう	nuu	to sew
濡らす	ぬらす	nurasu	to wet; to soak; to dip
	ねじ	neji	(a) screw
捩る	ねじる	nejiru	to twist
	ネックレス	nekkuresu	necklace
熱する	ねっする	nessuru	to heat
寝間着/寝巻	ねまき	nemaki	sleep-wear; nightclothes; pyjamas; nightgown; nightdress
狙い	ねらい	nerai	aim
狙う	ねらう	nerau	to aim at
年度	ねんど	nendo	year; fiscal year; school year; term
農産物	のうさんぶつ	nousanbutsu	agricultural produce
農村	のうそん	nouson	agricultural community; farm village; rural
濃度	のうど	noudo	concentration; brightness
農薬	のうやく	nouyaku	agricultural chemicals
能率	のうりつ	nouritsu	efficiency
	のこぎり	nokogiri	saw
残らず	のこらず	nokorazu	all; entirely; completely; without exception
載せる	のせる	noseru	to place on (something); to take on board; to give a ride
覗く	のぞく	nozoku	to peep in; to look in; to peek in; to stick out
延ばす	のばす	nobasu	to lengthen; to stretch; to reach out; to grow (beard)
延びる	のびる	nobiru	to be prolonged
上り	のぼり	nobori	up-train (going to Tokyo); ascent
上る	のぼる	noboru	to ascend; to go up; to climb
糊	のり	nori	paste; starch
乗換	のりかえ	norikae	(n) transfer (trains; buses; etc.)
載る	のる	noru	to appear (in print); to be recorded
鈍い	のろい	noroi	dull (e.g. a knife); thickheaded; slow (opposite of fast); stupid
	のろのろ	noronoro	slowly; sluggishly
呑気	のんき	nonki	carefree; optimistic; careless; reckless; heedless
灰色	はいいろ	haiiro	grey; gray; ashen
俳句	はいく	haiku	haiku poetry
拝見	はいけん	haiken	(hum) (pol) seeing; look at
売店	ばいてん	baiten	shop; stand
	バイバイ	baibai	bye-bye
売買	ばいばい	baibai	trade; buying and selling
這う	はう	hau	to creep; to crawl
生える	はえる	haeru	(1) to grow; to spring up; (2) to cut (teeth)
剥す	はがす	hagasu	to tear off; to peel off; to rip off
	ばからしい	bakarashii	absurd
秤	はかり	hakari	scales; weighing machine
量る/測る	はかる	hakaru	to measure; to weigh; to survey
吐き気	はきけ	hakike	nausea; sickness in the stomach
	はきはき	hakihaki	lucidly
掃く	はく	haku	to sweep; to brush; to gather up
歯車	はぐるま	haguruma	gear; cog-wheel
	バケツ	baketsu	bucket; pail
挟まる	はさまる	hasamaru	to get between; to be caught in
挟む	はさむ	hasamu	to interpose; to hold between; to insert
箸	はし	hashi	chopsticks
梯子	はしご	hashigo	ladder; stairs
始めに/初めに	はじめに	hajimeni	to begin with; first of all
	はじめまして	hajimemashite	How do you do?; I am glad to meet you
斜	はす	hasu	diagonal
外れる	はずれる	hazureru	to be disconnected; to get out of place; to be off; to be out (e.g. of gear)
	パターン	pataan	pattern
肌着	はだぎ	hadagi	underwear
果して	はたして	hatashite	as was expected; really
鉢	はち	hachi	a bowl; a pot
罰	ばつ	batsu	punishment
発揮	はっき	hakki	exhibition; demonstration; utilization; display
	バック	bakku	back
発射	はっしゃ	hassha	firing; shooting; discharge; catapult
発想	はっそう	hassou	expression (music); conceptualization
発電	はつでん	hatsuden	generation (e.g. power)
発売	はつばい	hatsubai	sale
派手	はで	hade	showy; loud; gay; flashy; gaudy
話合い	はなしあい	hanashiai	discussion; conference
話し掛ける	はなしかける	hanashikakeru	to accost a person; to talk (to someone)
話中	はなしちゅう	hanashichuu	while talking; the line is busy
甚だしい	はなはだしい	hanahadashii	extreme; excessive; terrible
花火	はなび	hanabi	fireworks
花嫁	はなよめ	hanayome	bride
放れる	はなれる	hanareru	to leave; to get free; to cut oneself off
羽根	はね	hane	shuttlecock
	ばね	bane	spring (e.g. coil; leaf)
跳ねる	はねる	haneru	to jump; to leap
破片	はへん	hahen	fragment; splinter; broken piece
歯磨き	はみがき	hamigaki	dentifrice; toothpaste
	はめる	hameru	(col) to get in; to insert; to put on; to make love
早口	はやくち	hayakuchi	fast-talking
流行る	はやる	hayaru	to flourish; to thrive; to be popular; to come into fashion
払い込む	はらいこむ	haraikomu	to deposit; to pay in
払い戻す	はらいもどす	haraimodosu	to repay; to pay back
	バランス	baransu	balance
針金	はりがね	harigane	wire
張り切る	はりきる	harikiru	to be in high spirits; to be full of vigor
反映	はんえい	hanei	reflection; influence
半径	はんけい	hankei	radius
判子	はんこ	hanko	seal (used for signature)
万歳	ばんざい	banzai	hurrah; cheers
判事	はんじ	hanji	judge; judiciary
反省	はんせい	hansei	reflection; reconsideration; introspection; meditation; contemplation
番地	ばんち	banchi	house number; address
	パンツ	pantsu	underpants
	バンド	bando	band
半島	はんとう	hantou	peninsula
	ハンドル	handoru	handle; steering wheel
日当たり	ひあたり	hiatari	exposure to the sun; sunny place
日帰り	ひがえり	higaeri	day trip
比較的	ひかくてき	hikakuteki	comparatively; relatively
日陰	ひかげ	hikage	shadow
	ぴかぴか	pikapika	glitter; sparkle
引受る	ひきうける	hikiukeru	to undertake; to take up; to take over
引返す	ひきかえす	hikikaesu	to repeat; to send back; to bring back
引算	ひきざん	hikizan	subtraction
引出す	ひきだす	hikidasu	to pull out; to take out; to draw out; to withdraw
引き止める	ひきとめる	hikitomeru	to detain; to check; to restrain
卑怯	ひきょう	hikyou	cowardice; meanness; unfairness
引分け	ひきわけ	hikiwake	a draw (in competition); tie game
髭	ひげ	hige	moustache; beard; whiskers
陽射	ひざし	hizashi	sunlight; rays of the sun
肘	ひじ	hiji	elbow
	ピストル	pisutoru	pistol
	ビタミン	bitamin	vitamin
	ぴたり	pitari	suddenly; tightly (ぴったり); perfectly (ぴったり)
引っ掛かる	ひっかかる	hikkakaru	to be caught in; to be stuck in; to be cheated
筆記	ひっき	hikki	(taking) notes; copying
引っ繰り返す	ひっくりかえす	hikkurikaesu	to turn over; to overturn; to knock over; to upset; to turn inside out
引っ繰り返る	ひっくりかえる	hikkurikaeru	to be overturned; to be upset; to topple over; to be reversed
引越し	ひっこし	hikkoshi	moving (dwelling etc.); changing residence
引っ込む	ひっこむ	hikkomu	to draw back; to sink; to cave in
筆者	ひっしゃ	hissha	writer; author
必需品	ひつじゅひん	hitsujuhin	necessities; necessary article; requisite; essential
人差指	ひとさしゆび	hitosashiyubi	index finger
一通り	ひととおり	hitotoori	ordinary; usual; in general; briefly
人通り	ひとどおり	hitodoori	pedestrian traffic
	ひとまず	hitomazu	for the present; once; in outline
瞳	ひとみ	hitomi	pupil (of eye)
一休み	ひとやすみ	hitoyasumi	a rest
独り言	ひとりごと	hitorigoto	a soliloquy; a monologue; speaking to oneself
	ひとりでに	hitorideni	by itself; automatically; naturally
	ビニール	biniiru	vinyl
皮肉	ひにく	hiniku	cynicism; sarcasm
日日	ひにち	hinichi	every day; daily; day after day
捻る	ひねる	hineru	to turn (a switch) on or off; to twist; to puzzle over
日の入り	ひのいり	hinoiri	sunset
日の出	ひので	hinode	sunrise
響き	ひびき	hibiki	echo; sound; reverberation; noise
響く	ひびく	hibiku	to resound
皮膚	ひふ	hifu	skin
冷やす	ひやす	hiyasu	to cool; to refrigerate
	ひゃっかじてん	hyakkajiten	encyclopedia
美容	びよう	biyou	beauty of figure or form
表紙	ひょうし	hyoushi	front cover; binding
標識	ひょうしき	hyoushiki	sign; mark
標準	ひょうじゅん	hyoujun	standard; level
標本	ひょうほん	hyouhon	example; specimen
評論	ひょうろん	hyouron	criticism; critique
平仮名	ひらがな	hiragana	hiragana; 47 syllables; the cursive syllabary
	ビルディング	birudingu	building
昼寝	ひるね	hirune	nap (at home); siesta
広げる	ひろげる	hirogeru	to spread; to extend; to expand; to enlarge
広さ	ひろさ	hirosa	extent
広場	ひろば	hiroba	plaza
広々	ひろびろ	hirobiro	extensive; spacious
広める	ひろめる	hiromeru	to broaden; to propagate
	ピンク	pinku	pink
便箋	びんせん	binsen	writing paper; stationery
瓶詰	びんづめ	binzume	bottling; bottled
	ファスナー	fasunaa	fastener; zipper
風船	ふうせん	fuusen	balloon
不運	ふうん	fuun	unlucky; misfortune; bad luck; fate
殖える	ふえる	fueru	to increase; to multiply
深まる	ふかまる	fukamaru	to deepen; to heighten; to intensify
不規則	ふきそく	fukisoku	irregularity; unsteadiness; disorderly
普及	ふきゅう	fukyuu	diffusion; spread
付近	ふきん	fukin	neighbourhood; vicinity; environs
拭く	ふく	fuku	to wipe; to dry
副詞	ふくし	fukushi	adverb
複写	ふくしゃ	fukusha	copy; duplicate
複数	ふくすう	fukusuu	plural; multiple
含める	ふくめる	fukumeru	to include; to instruct; to make one understand
膨らます	ふくらます	fukuramasu	to swell; to expand; to inflate; to bulge
膨らむ	ふくらむ	fukuramu	to expand; to swell (out); to get big; to become inflated
不潔	ふけつ	fuketsu	unclean; dirty; filthy; impure
更ける	ふける	fukeru	to get late; to advance; to wear on
符号	ふごう	fugou	sign; mark; symbol
夫妻	ふさい	fusai	man and wife; married couple
塞がる	ふさがる	fusagaru	to be plugged up; to be shut up
塞ぐ	ふさぐ	fusagu	to stop up; to close up; to block (up)
	ふざける	fuzakeru	to romp; to gambol; to frolic; to joke
無沙汰	ぶさた	busata	neglecting to stay in contact
武士	ぶし	bushi	warrior; samurai
部首	ぶしゅ	bushu	radical (of a kanji character)
襖	ふすま	fusuma	sliding screen
附属	ふぞく	fuzoku	attached; belonging; affiliated
蓋	ふた	futa	cover; lid; cap
不通	ふつう	futsuu	suspension; interruption; stoppage; tie-up; cessation
	ぶつかる	butsukaru	to strike; to collide with
	ぶつける	butsukeru	to knock; to run into; to nail on; to strike hard; to hit and attack
物騒	ぶっそう	bussou	dangerous; disturbed; insecure
	ぶつぶつ	butsubutsu	grumbling; complaining in a small voice
船便	ふなびん	funabin	surface mail (ship)
部品	ぶひん	buhin	parts; accessories
吹雪	ふぶき	fubuki	snow storm
父母	ふぼ	fubo	father and mother; parents
踏切	ふみきり	fumikiri	railway crossing; level crossing; starting line; scratch; crossover
麓	ふもと	fumoto	the foot; the bottom; the base (of a mountain)
増やす/殖やす	ふやす	fuyasu	to increase; to add to; to augment
	フライパン	furaipan	fry pan; frying pan
	ブラウス	burausu	blouse
	ぶらさげる	burasageru	to hang; to suspend; to dangle; to swing
	ブラシ	burashi	brushy; brush
	プラスチック	purasuchikku	plastic
	プラットホーム	purattohoomu	platform
	フリー	furii	free
振り仮名	ふりがな	furigana	; pronunciation key
	プリント	purinto	print; handout
振舞う	ふるまう	furumau	to behave; to conduct oneself; to entertain (vt)
	ブローチ	buroochi	brooch
	プログラム	puroguramu	program
風呂敷	ふろしき	furoshiki	wrapping cloth; cloth wrapper
	ふわふわ	fuwafuwa	light; soft
噴火	ふんか	funka	eruption
分解	ぶんかい	bunkai	analysis; disassembly
文芸	ぶんげい	bungei	literature; art and literature; belles-lettres
文献	ぶんけん	bunken	literature; books (reference)
噴水	ふんすい	funsui	water fountain
分数	ぶんすう	bunsuu	fraction (in math)
文体	ぶんたい	buntai	literary style
分布	ぶんぷ	bunpu	distribution
文房具	ぶんぼうぐ	bunbougu	stationery
文脈	ぶんみゃく	bunmyaku	context
分量	ぶんりょう	bunryou	amount; quantity
分類	ぶんるい	bunrui	classification
閉会	へいかい	heikai	closure
平気	へいき	heiki	coolness; calmness; composure; unconcern
並行	へいこう	heikou	(going) side by side; concurrent; abreast; at the same time
平日	へいじつ	heijitsu	weekday; ordinary days
兵隊	へいたい	heitai	soldier; sailor
平凡	へいぼん	heibon	common; commonplace; ordinary; mediocre
平野	へいや	heiya	plain; open field
凹む	へこむ	hekomu	to be dented; to be indented; to yield to; to give; to sink; to collapse; to cave in; to be snubbed
	へそ	heso	navel; belly-button
隔てる	へだてる	hedateru	to be shut out
別荘	べっそう	bessou	holiday house; villa
別々	べつべつ	betsubetsu	separately; individually
	ベテラン	beteran	veteran
	ヘリコプター	herikoputaa	helicopter
	へる	heru	to decrease (in size or number); to diminish; to abate
	ぺん	pen	pen
編集	へんしゅう	henshuu	editing; compilation; editorial (e.g. committee)
便所	べんじょ	benjo	toilet; lavatory; rest room; latrine; comfort station
	ペンチ	penchi	(abbr) pliers (lit: pinchers)
望遠鏡	ぼうえんきょう	bouenkyou	telescope
方角	ほうがく	hougaku	direction; way; compass point
箒	ほうき	houki	(n) broom
方言	ほうげん	hougen	dialect
坊さん	ぼうさん	bousan	Buddhist priest; monk
防止	ぼうし	boushi	prevention; check
方針	ほうしん	houshin	objective; plan; policy
包装	ほうそう	housou	packing; wrapping
法則	ほうそく	housoku	law; rule
包帯	ほうたい	houtai	bandage; dressing
膨大	ぼうだい	boudai	huge; bulky; enormous; extensive; swelling; expansion
庖丁	ほうちょう	houchou	kitchen knife; carving knife
方程式	ほうていしき	houteishiki	equation
防犯	ぼうはん	bouhan	prevention of crime
方面	ほうめん	houmen	direction; district; field (e.g.; of study)
坊や	ぼうや	bouya	boy
放る	ほうる	houru	to let go
	ボーナス	boonasu	bonus
朗らか	ほがらか	hogaraka	brightness; cheerfulness; melodious
牧場	ぼくじょう	bokujou	(1) farm (livestock); (2) pasture land; meadow; grazing land
牧畜	ぼくちく	bokuchiku	stock-farming
保健	ほけん	hoken	health preservation; hygiene; sanitation
募集	ぼしゅう	boshuu	recruiting; taking applications
干す	ほす	hosu	to air; to dry; to desiccate; to drain (off); to drink up
	ポスター	posutaa	poster
北極	ほっきょく	hokkyoku	North Pole
坊っちゃん	ぼっちゃん	bocchan	son (of others)
	ほどく	hodoku	to unfasten
堀	ほり	hori	moat; canal
掘る	ほる	horu	to dig; to excavate
彫る	ほる	horu	to carve; to engrave; to sculpture; to chisel
	ぼろ	boro	rag; scrap; tattered clothes; fault (esp. in a pretense)
盆	ぼん	bon	Lantern Festival; Festival of the Dead; tray
盆地	ぼんち	bonchi	basin (e.g. between mountains)
本部	ほんぶ	honbu	headquarters
本来	ほんらい	honrai	essentially; naturally; by nature
	まあまあ	maamaa	so-so
枚数	まいすう	maisuu	the number of flat things
毎度	まいど	maido	each time; common service-sector greeting
	マイナス	mainasu	minus
巻く	まく	maku	to wind; to coil; to roll
蒔く	まく	maku	to sow (seeds)
撒く	まく	maku	to scatter; to sprinkle; to sow
枕	まくら	makura	pillow; bolster
曲げる	まげる	mageru	to bend; to crook; to lean
	まごまご	magomago	confused
摩擦	まさつ	masatsu	friction; rubbing; rubdown; chafe
混ざる/交ざる	まざる	mazaru	to be mixed; to be blended with; to associate with; to mingle with; to join
混じる/交じる	まじる	mazaru	to be mixed; to be blended with; to associate with; to mingle with; to join
混じる	まじる	majiru	to be mixed; to be blended with; to associate with
交じる	まじる	majiru	to be mixed; to be blended with; to associate with
	マスク	masuku	mask
混ぜる/交ぜる	まぜる	mazeru	to mix; to stir
	またぐ	matagu	to straddle
又は	または	mataha	or; otherwise
待合室	まちあいしつ	machiaishitsu	waiting room
待ち合わせる	まちあわせる	machiawaseru	to rendezvous; to meet at a prearranged place and time
街角	まちかど	machikado	street corner
真っ暗	まっくら	makkura	total darkness; shortsightedness; pitch dark
真っ黒	まっくろ	makkuro	pitch black
真っ青	まっさお	massao	deep blue; ghastly pale
真っ先	まっさき	massaki	the head; the foremost; beginning
真っ白	まっしろ	masshiro	pure white
祭る	まつる	matsuru	to deify; to enshrine
窓口	まどぐち	madoguchi	ticket window
纏まる	まとまる	matomaru	to be collected; to be settled; to be in order
纏める	まとめる	matomeru	to put in order; to collect; to bring to a conclusion
真似る	まねる	maneru	to mimic; to imitate
	まぶしい	mabushii	dazzling; radiant
	まぶた	mabuta	eyelids
	マフラー	mafuraa	muffler; scarf
間も無く	まもなく	mamonaku	soon; before long; in a short time
	マラソン	marason	marathon
円い	まるい	marui	round; circular; spherical
稀	まれ	mare	rare; seldom
回り道	まわりみち	mawarimichi	detour
満員	まんいん	manin	full house; no vacancy; sold out
	マンション	manshon	large apartment; apartment house
満点	まんてん	manten	perfect score
見送る	みおくる	miokuru	(1) to see off; to farewell; (2) to escort; (3) to let pass
見下ろす	みおろす	miorosu	to overlook; to command a view of; to look down on something
見掛け	みかけ	mikake	outward appearance
三日月	みかづき	mikazuki	new moon; crescent moon
岬	みさき	misaki	cape (on coast)
	みじめ	mijime	(arch) sad; pitiful; wretched
	ミシン	mishin	sewing machine
店屋	みせや	miseya	store; shop
見出し	みだし	midashi	heading; caption; subtitle; index
道順	みちじゅん	michijun	itinerary; route
見付かる	みつかる	mitsukaru	to be found; to be discovered
見付ける	みつける	mitsukeru	to be familiar; to discover; to detect
	みっともない	mittomonai	shameful; indecent
見直す	みなおす	minaosu	to look again; to get a better opinion of
見慣れる	みなれる	minareru	to become used to seeing; to be familiar with
醜い	みにくい	minikui	ugly
実る	みのる	minoru	to bear fruit; to ripen
身分	みぶん	mibun	social position; social status
見本	みほん	mihon	sample
見舞う	みまう	mimau	to ask after (health); to visit
未満	みまん	miman	less than; insufficient
名字	みょうじ	myouji	surname; family name
	ミリ(メートル)	miri(meetoru)	milli-; 10^-3
診る	みる	miru	to examine (medical)
民間	みんかん	minkan	private; civilian; civil; popular; folk; unofficial
民謡	みんよう	minyou	folk song; popular song
向う	むかう	mukau	(v5u) to face; to go towards
剥く	むく	muku	to peel; to skin; to pare; to hull
無限	むげん	mugen	infinite
無地	むじ	muji	plain; unfigured
蒸し暑い	むしあつい	mushiatsui	humid; sultry
矛盾	むじゅん	mujun	contradiction; inconsistency
蒸す	むす	musu	to steam; to poultice; to be sultry
無数	むすう	musuu	countless number; infinite number
紫	むらさき	murasaki	purple colour; violet
群れ	むれ	mure	group; crowd; flock; herd
姪	めい	mei	niece
名作	めいさく	meisaku	masterpiece
名刺	めいし	meishi	business card
名詞	めいし	meishi	noun
名所	めいしょ	meisho	famous place
命ずる	めいずる	meizuru	to command; to appoint
迷信	めいしん	meishin	superstition
名物	めいぶつ	meibutsu	famous product; special product; speciality
銘々	めいめい	meimei	each; individual
目上	めうえ	meue	superior(s); senior
	メーター	meetaa	meter (clock)
恵まれる	めぐまれる	megumareru	to be blessed with; to be rich in
巡る	めぐる	meguru	to go around
目指す	めざす	mezasu	to aim at; to have an eye on
目覚し	めざまし	mezamashi	(abbr) alarm-clock
目下	めした	meshita	at present; now
目印	めじるし	mejirushi	mark; sign; landmark
目立つ	めだつ	medatsu	to be conspicuous; to stand out
	めちゃくちゃ	mechakucha	absurd; unreasonable; excessive; messed up; spoiled; wreaked
	めっきり	mekkiri	remarkably
	めでたい	medetai	happy; simple soul; propitious; joyous
	メニュー	menyuu	menu
	めまい	memai	dizziness; giddiness
目安	めやす	meyasu	criterion; aim
免税	めんぜい	menzei	tax exemption; duty exemption
面積	めんせき	menseki	area
面接	めんせつ	mensetsu	interview
面倒臭い	めんどうくさい	mendoukusai	bother to do; tiresome
儲かる	もうかる	moukaru	to be profitable; to yield a profit
儲ける	もうける	moukeru	to get; to earn; to gain; to have (bear; beget) a child
申し訳ない	もうしわけない	moushiwakenai	inexcusable
	モーター	mootaa	motor
木材	もくざい	mokuzai	lumber; timber; wood
目次	もくじ	mokuji	table of contents
潜る	もぐる	moguru	(1) to drive; to pass through; (2) to evade; to hide; (3) to dive (into or under water); to go undergroun
	もしかしたら/もしかすると	moshikashitara/ moshikasuruto	perhaps; maybe; by some chance
	もたれる	motareru	to lean against; to lean on; to recline on; to lie heavy (on the stomach)
	モダン	modan	modern
餅	もち	mochi	sticky rice cake
	もったいない	mottainai	too good; more than one deserves; wasteful; sacrilegious; unworthy of
	モデル	moderu	model
元々	もともと	motomoto	originally; by nature; from the start
物置	ものおき	monooki	storage room
物語る	ものがたる	monogataru	to tell; to indicate
物差し	ものさし	monosashi	ruler; measure
物凄い	ものすごい	monosugoi	earth-shattering; staggering; to a very great extent
	モノレール	monoreeru	monorail
紅葉	もみじ	momiji	(1) (Japanese) maple
揉む	もむ	momu	to rub; to crumple (up); to wrinkle
燃やす	もやす	moyasu	to burn
催し	もよおし	moyooshi	event; festivities; function
盛る	もる	moru	(1) to serve (food; etc.); (2) to fill up; (3) to prescribe
問答	もんどう	mondou	questions and answers; dialogue
	やかましい	yakamashii	(1) noisy; (2) strict; fussy
夜間	やかん	yakan	at night; nighttime
薬缶	やかん	yakan	kettle
役者	やくしゃ	yakusha	actor; actress
役所	やくしょ	yakusho	government office; public office
訳す	やくす	yakusu	to translate
役人	やくにん	yakunin	government official
薬品	やくひん	yakuhin	medicine(s); chemical(s)
役目	やくめ	yakume	duty; business
火傷	やけど	yakedo	burn; scald
夜行	やこう	yakou	walking around at night; night train; night travel
矢印	やじるし	yajirushi	directing arrow
	やたらに	yatarani	randomly; recklessly; blindly
薬局	やっきょく	yakkyoku	pharmacy; drugstore
	やっつける	yattsukeru	to attack (an enemy); to beat; to do away with; to finish off
家主	やぬし	yanushi	landlord
	やっぱり	yappari	also; as I thought; still; in spite of; absolutely; of course
破く	やぶく	yabuku	tear; rend; breach; break; destroy
破れる	やぶれる	yabureru	to get torn; to wear out
	やむをえない	yamuoenai	cannot be helped; unavoidable
軟らかい	やわらかい	yawarakai	soft; tender; limp
遊園地	ゆうえんち	yuuenchi	amusement park
夕刊	ゆうかん	yuukan	evening paper
友好	ゆうこう	yuukou	friendship
郵送	ゆうそう	yuusou	mailing
夕立	ゆうだち	yuudachi	(sudden) evening shower (rain)
夕日	ゆうひ	yuuhi	(in) the evening sun; setting sun
悠々	ゆうゆう	yuuyuu	quiet; calm; leisurely
有料	ゆうりょう	yuuryou	admission-paid; toll
浴衣	ゆかた	yukata	bathrobe; informal summer kimono; yukata
湯気	ゆげ	yuge	steam; vapour
輸血	ゆけつ	yuketsu	blood transfusion
輸送	ゆそう	yusou	transport; transportation
油断	ゆだん	yudan	negligence; unpreparedness
	ゆでる	yuderu	to boil
湯飲み	ゆのみ	yunomi	teacup
緩い	ゆるい	yurui	loose; lenient; slow
溶岩	ようがん	yougan	lava
容器	ようき	youki	container; vessel
用語	ようご	yougo	term; terminology
要旨	ようし	youshi	gist; essentials; summary; fundamentals
幼児	ようじ	youji	infant; baby; child
容積	ようせき	youseki	capacity; volume
幼稚	ようち	youchi	infancy; childish; infantile
幼稚園	ようちえん	youchien	kindergarten
用途	ようと	youto	use; usefulness
洋品店	ようひんてん	youhinten	shop which handles Western-style apparel and accessories
養分	ようぶん	youbun	nourishment; nutrient
羊毛	ようもう	youmou	wool
漸く	ようやく	youyaku	gradually; finally; hardly
要領	ようりょう	youryou	point; gist; essentials; outline
欲張り	よくばり	yokubari	avarice; covetousness; greed
余計	よけい	yokei	too much; unnecessary; abundance; surplus; excess; superfluity
	よこす	yokosu	(1) to send; to forward; (2) to hand over (e.g. money)
汚す	よごす	yogosu	(1) to disgrace; to dishonour; (2) to pollute; to contaminate; to soil; to make dirty; to stain
寄せる	よせる	yoseru	to collect; to gather; to add; to put aside
余所	よそ	yoso	another place; somewhere else; strange parts
四つ角	よつかど	yotsukado	four corners; crossroads
酔っ払い	よっぱらい	yopparai	drunkard
予備	よび	yobi	preparation; preliminaries; reserve; spare
呼び掛ける	よびかける	yobikakeru	to call out to; to accost; to address (crowd); to appeal
呼び出す	よびだす	yobidasu	to summon; to call (e.g. phone)
蘇る	よみがえる	yomigaeru	to be resurrected; to be revived; to be resuscitated; to be rehabilitated
因る	よる	yoru	to come from
慶び	よろこび	yorokobi	(n) (a) joy; (a) delight; rapture; pleasure; gratification; rejoicing; congratulations; felicitations
慶ぶ	よろこぶ	yorokobu	to be delighted; to be glad; to be pleased
来日	らいにち	rainichi	arrival in Japan; coming to Japan; visit to Japan
落第	らくだい	rakudai	failure; dropping out of a class
	ラッシュアワー	rasshuawaa	rush hour
欄	らん	ran	column of text (e.g. as in a newspaper)
	ランチ	ranchi	launch; lunch
	ランニング	ranningu	(1) running; (2) tank top
乱暴	らんぼう	ranbou	rude; violent; rough; lawless; unreasonable; reckless
理科	りか	rika	science
利害	りがい	rigai	advantages and disadvantages; interest
	リズム	rizumu	rhythm
	リットル	rittoru	litre
	リボン	ribon	ribbon
略す	りゃくす	ryakusu	to abbreviate
流域	りゅういき	ryuuiki	(river) basin
寮	りょう	ryou	hostel; dormitory
両側	りょうがわ	ryougawa	both sides
漁師	りょうし	ryoushi	fisherman
領事	りょうじ	ryouji	consul
領収	りょうしゅう	ryoushuu	receipt; voucher
臨時	りんじ	rinji	temporary; special; extraordinary
留守番	るすばん	rusuban	care-taking; caretaker; house-watching
例外	れいがい	reigai	exception
零点	れいてん	reiten	zero; no marks
冷凍	れいとう	reitou	freezing; cold storage; refrigeration
	レインコート	reinkooto	raincoat
	レクリェーション	rekureeshon	recreation
	レジャー	rejaa	leisure
列島	れっとう	rettou	chain of islands
	レベル	reberu	level
	リポート	ripooto	report; paper
煉瓦	れんが	renga	brick
連合	れんごう	rengou	union; alliance
	レンズ	renzu	lens
蝋燭	ろうそく	rousoku	candle
	ローマじ	roomaji	romanization; Roman letters
録音	ろくおん	rokuon	(audio) recording
	ロッカー	rokkaa	locker
	ロビー	robii	lobby
論ずる	ろんずる	ronzuru	to argue; to discuss; to debate
和英	わえい	waei	Japanese-English
分る	わかる	wakaru	to be understood
分かれる	わかれる	wakareru	to branch off; to diverge from; to fork; to split; to dispense; to scatter; to divide into
若々しい	わかわかしい	wakawakashii	youthful; young
湧く	わく	waku	to boil; to grow hot; to get excited; to gush forth
詫びる	わびる	wabiru	to apologize
和服	わふく	wafuku	Japanese clothes
	わりあいに	wariaini	comparatively
割算	わりざん	warizan	division (math)
割と	わりと	warito	relatively; comparitively
割引	わりびき	waribiki	discount; reduction; rebate
椀	わん	wan	Japanese soup bowl; wooden bowl
碗	わん	wan	bowl
	ワンピース	wanpiisu	one-piece dress