	あいかわらず	aikawarazu	как всегда; как обычно; то же самое
	アイデア/アイディア	aidea/aidia	идея
	あいまい	aimai	расплывчато; неоднозначно
遭う	あう	au	встретиться, столкнуться (обычно с ч-л нежелательным)
扇ぐ	あおぐ	aogu	раздуть; махать
青白い	あおじろい	aojiroi	бледный
	あかんぼう	akanbou	ребенок
明き	あき	aki	комната; пустота; открытое пространство
	あきれる	akireru	удивляться; быть шокированыv
	アクセント	akusento	акцент
	あくび	akubi	зевать
飽くまで	あくまで	akumade	до конца; до последнего; упорно
明け方	あけがた	akegata	рассвет
揚げる	あげる	ageru	поднимать; обжаривать
挙げる	あげる	ageru	поднять; поймать; упоминать; приводить
	あげる (=やる)	ageru (=yaru)	делать 
憧れる	あこがれる	akogareru	тосковать по; восхищаться; любоваться
足跡	あしあと	ashiato	следы
味わう	あじわう	ajiwau	пробовать на вкус; наслаждаться
預かる	あずかる	azukaru	брать на время; принимать на хранение
暖まる	あたたまる	atatamaru	согреваться
暖める	あたためる	atatameru	нагреваться 
	あたりまえ	atarimae	обычно; конечно
	あちらこちら	achirakochira	там и сям
厚かましい	あつかましい	atsukamashii	наглый; бесстыдный 
圧縮	あっしゅく	asshuku	сжатие; давление
宛名	あてな	atena	адрес; получатель
	あてはまる	atehamaru	быть применимо; попасть под (категорию) 
	あてはめる	atehameru	применять; адаптировать
暴れる	あばれる	abareru	действовать жестоко; бушевать; бороться 
脂	あぶら	abura	жир; сало 
	あぶる	aburu	палить
	あふれる	afureru	затапливать; переполнять; переливаться через край
雨戸	あまど	amado	раздвижные ставни
甘やかす	あまやかす	amayakasu	баловать 
余る	あまる	amaru	оставаться; быть в избытке
編物	あみもの	amimono	вязание
編む	あむ	amu	вязать
危うい	あやうい	ayaui	опасный
怪しい	あやしい	ayashii	подозрительный; сомнительный 
荒い	あらい	arai	грубо; дикий
粗い	あらい	arai	грубый; шероховатый
	あらすじ	arasuji	наброски; резюме
争う	あらそう	arasou	оспаривать; спорить; противоречить; конкурировать
改めて	あらためて	aratamete	опять же; снова и снова; заново
改める	あらためる	aratameru	изменять; переделывать; реформировать 
著す	あらわす	arawasu	писать; публиковать
有難い	ありがたい	arigatai	быть благодарным 
在る	ある	aru	жить; существовать
	あれこれ	arekore	одно или другое; то и это; то или иное
	あわただしい	awatadashii	запутанный; взбудораженный
	あわてる	awateru	запутаться
安易	あんい	ani	спокойный
案外	あんがい	angai	неожиданно
	アンテナ	antena	антенна
言い出す	いいだす	iidasu	говорить 
言い付ける	いいつける	iitsukeru	передавать (на словах); посылать
意義	いぎ	igi	смысл; значение
生き生き	いきいき	ikiiki	ярко; живо
	いきなり	ikinari	резко; вдруг; внезапно; без предупреждения
育児	いくじ	ikuji	уход за детьми; уход за больными; воспитание
幾分	いくぶん	ikubun	отчасти
生け花	いけばな	ikebana	икебана
以後	いご	igo	после этого; с этого момента; в дальнейшем; после
以降	いこう	ikou	и после; далее; после этого
	イコール	ikooru	равный
勇ましい	いさましい	isamashii	храбрый; отважный; доблестный; мужественный
衣食住	いしょくじゅう	ishokujuu	необходимое для жизни (питание; одежда и т. д.)
意地悪	いじわる	ijiwaru	злоба; упрямство
	いちいち	ichiichi	один за другим; отдельно
一応	いちおう	ichiou	в общем; грубо говоря; для начала
一段と	いちだんと	ichidanto	более; далее 
一流	いちりゅう	ichiryuu	первый класс; высший сорт; прежде всего; первоклассный
逸	いつ	itsu	пассивность; праздность
一昨日	いっさくじつ	issakujitsu	позавчера
一昨年	いっさくねん	issakunen	позапрошлый год
一斉	いっせい	issei	одновременно; все сразу
一旦	いったん	ittan	один раз; на мгновение; однажды утром; временно
一定	いってい	ittei	фиксированной; поселились; определенная
	いつのまにか	itsunomanika	прежде чем 
移転	いてん	iten	перемещение; передача
井戸	いど	ido	колодец
緯度	いど	ido	широта (геогр.)
従姉妹	いとこ	itoko	двоюродная сестра
威張る	いばる	ibaru	гордиться; куражиться
嫌がる	いやがる	iyagaru	ненавидеть; не любить
	いよいよ	iyoiyo	все больше и больше; тем более; более; наконец; вне всякого сомнения; 
煎る	いる	iru	жарить
炒る	いる	iru	жарить
入れ物	いれもの	iremono	контейнер; так; розетка
	インキ	inki	чернила
	インタビュー	intabyuu	интервью
引力	いんりょく	inryoku	вес
	ウーマン	uuman	женщина
	ウール	uuru	шерсть
	ウエートレス	ueetoresu	официантка
植木	うえき	ueki	сад кустарники; деревья; растение в горшке
飢える	うえる	ueru	голодать
浮ぶ	うかぶ	ukabu	плавать; подняться на поверхность; приходить на ум
浮かべる	うかべる	ukaberu	спускать на воду; показывать (улыбку, слёзы); вызывать (в памяти, в мыслях)
浮く	うく	uku	плавать; всплывать; поддниматься
承る	うけたまわる	uketamawaru	вежл. слушать; слышать; узнавать
受取	うけとり	uketori	квитанция
受け持つ	うけもつ	ukemotsu	отвечать за что-л.
薄暗い	うすぐらい	usugurai	тусклый; мрачный
薄める	うすめる	usumeru	разбавлять; смягчать; послаблять
打合せ	うちあわせ	uchiawase	деловая встреча; предыдущая договоренность; назначение
打ち消す	うちけす	uchikesu	отрицать; противоречить
討つ	うつ	utsu	атаковать
	うっかり	ukkari	небрежно; бездумно; случайно
映す	うつす	utsusu	отражать; бросать (тень)
写る	うつる	utsuru	фотографироваться; копировать
映る	うつる	utsuru	отражать; бросать (тень)
	うどん	udon	лапша (японские)
有無	うむ	umu	да или нет; существование; указатель срабатывания (компрессор); наличие или отсутствие маркера
埋める	うめる	umeru	похоронить; заполнить (место , должность)
敬う	うやまう	uyamau	уважать
裏返す	うらがえす	uragaesu	вывернуть наизнанку; чтобы включить (что-то) над
裏口	うらぐち	uraguchi	бэкдор; задний вход
占う	うらなう	uranau	прогнозировать; предсказывать
恨み	うらみ	urami	негодование; ярость
恨む	うらむ	uramu	проклинать; злиться
羨ましい	うらやましい	urayamashii	завидный
羨む	うらやむ	urayamu	завидовать
売上	うりあげ	uriage	объем реализации; доходы
売り切れ	うりきれ	urikire	полная продажа
売り切れる	うりきれる	urikireru	быть проданым полностью
売行き	うれゆき	ureyuki	реализация
	うろうろ	urouro	бесцельное блуждать
運河	うんが	unga	водный канал; 
	うんと	unto	много; очень много
英文	えいぶん	eibun	предложение в английском языке
英和	えいわ	eiwa	англо-японский (например словарь)
	ええと	eeto	ну; э-э....
液体	えきたい	ekitai	жидкость; 
	エチケット	echiketto	этикет
絵の具	えのぐ	enogu	краска
	エプロン	epuron	фартук
偉い	えらい	erai	большой; выдающийся; замечательный; превосходный
宴会	えんかい	enkai	банкет
園芸	えんげい	engei	садоводство; 
演劇	えんげき	engeki	театральная постановка
円周	えんしゅう	enshuu	окружность
遠足	えんそく	ensoku	экскурсия; загородная прогулка; пикник
延長	えんちょう	enchou	расширение; удлинение; продление 
煙突	えんとつ	entotsu	дымоход
追い掛ける	おいかける	oikakeru	преследовать; бежать за кем-то 
追い越す	おいこす	oikosu	опередить; обогнать
	オイル	oiru	нефть; масло; керосин
応援	おうえん	ouen	помощь; содействие 
王女	おうじょ	oujo	принцесса
応ずる	おうずる	ouzuru	отвечать; удовлетворить (требованию); принимать
応接	おうせつ	ousetsu	прием
応対	おうたい	outai	обращение (с людьми); прием
往復	おうふく	oufuku	поездка туда и обратно; переписка
欧米	おうべい	oubei	Европа и Америка; запад
応用	おうよう	ouyou	применить на практике
	オーケストラ	ookesutora	оркестр
	おおざっぱ	oozappa	грубо (не точно); приблизительно
大通り	おおどおり	oodoori	главная улица
	オートメーション	ootomeeshon	автоматизация
	オーバーコート	oobaakooto	пальто
大凡	おおよそ	ooyoso	грубо говоря; как правило; примерно
お帰り	おかえり	okaeri	возвращение; добро пожаловать
	おかけください	okakekudasai	садитесь
	おかげさまで	okagesamade	благодаря вам
	おかず	okazu	гарнир к блюдам из риса
拝む	おがむ	ogamu	поклоняться; просить; молиться
お代わり	おかわり	okawari	добавка; следущая порция
補う	おぎなう	oginau	компенсировать
	おきのどくに	okinodokuni	мои соболезнования
屋外	おくがい	okugai	на открытом воздухе
	おくさん	okusan	(веждиво) ваша жена 
送り仮名	おくりがな	okurigana	сопроводительная кана
	おげんきで	ogenkide	берегите себя
怠る	おこたる	okotaru	пренебрегать; отлынивать; ослаблять внимание
押える	おさえる	osaeru	останавливать; сдерживать; подавлять; подавить; давить
	おさきに	osakini	прежде; впереди; ранее
納める	おさめる	osameru	получать; пожинать; заплатить; принимать
治める	おさめる	osameru	 управлять; чтобы подчинять
惜しい	おしい	oshii	жаль; достойный лучшего
お辞儀	おじぎ	ojigi	поклон
伯父さん/小父さん/叔父さん	おじさん	ojisan	мужчина среднего возраста; дядя
	おしゃれ	oshare	мода
	おじゃまします	ojamashimasu	простите за беспокойство
教わる	おそわる	osowaru	учить
	おだいじに	odaijini	берегите себя
落着く	おちつく	ochitsuku	успокоиться
お手洗	おてあらい	otearai	мытьё рук; рукомойник
お出掛け	おでかけ	odekake	выходить; отправляться
お手伝いさん	おてつだいさん	otetsudaisan	помощник
	おどかす	odokasu	угрожать; пугать
落し物	おとしもの	otoshimono	находка
	おととい	ototoi	позавчера
	おととし	ototoshi	позапрошлый год
	おとなしい	otonashii	послушный; тихий
驚かす	おどろかす	odorokasu	удивить; напугать 
	おねがいします	onegaishimasu	пожалуйста
各々	おのおの	onoono	каждый; по отдельности
伯母さん/叔母さん	おばさん	obasan	(вежливо) тетя; женщина средних лет
	おはよう	ohayou	(сокр) доброе утро
お参り	おまいり	omairi	поклонение; визит
	おまたせしました	omataseshimashita	извините, что заставили вас ждать
	おまちください	omachikudasai	пожалуйста, подождите 
	おまちどおさま	omachidoosama	извините, что заставили вас ждать
	おめでたい	omedetai	радостное событие
思い掛けない	おもいがけない	omoigakenai	неожиданно; случайно
思い込む	おもいこむ	omoikomu	быть под впечатлением
思いっ切り	おもいっきり	omoikkiri	решительно
思い付く	おもいつく	omoitsuku	думать; вспомнить
重たい	おもたい	omotai	тяжелый; массивный; серьезный
	おやすみ	oyasumi	 отдых; спокойной ночи
	おやつ	oyatsu	полдник
親指	おやゆび	oyayubi	большой палец руки
	オルガン	orugan	орган
卸す	おろす	orosu	продавать оптом 
恩恵	おんけい	onkei	благодать; милость; благословение
温室	おんしつ	onshitsu	теплица
温泉	おんせん	onsen	горячие источники; онсэн
温帯	おんたい	ontai	умеренный пояс
御中	おんちゅう	onchuu	суффикс к названиям компаний и учреждений (обычно не переводится)
蚊	か	ka	комар
	カーブ	kaabu	 кривая 
貝	かい	kai	 моллюск; раковина
開会	かいかい	kaikai	открытие встречи
会館	かいかん	kaikan	зал заседаний; актовый зал
改札	かいさつ	kaisatsu	проверка билетов
解散	かいさん	kaisan	распад; растворение
海水浴	かいすいよく	kaisuiyoku	купание в морской воде
回数	かいすう	kaisuu	частота
回数券	かいすうけん	kaisuuken	купон; отрывной талон
改正	かいせい	kaisei	пересмотр; поправка; изменение
快晴	かいせい	kaisei	хорошая погода
解説	かいせつ	kaisetsu	объяснение; комментарий
改造	かいぞう	kaizou	 ремонт
開通	かいつう	kaitsuu	открытие 
回転	かいてん	kaiten	вращение; революция; поворот
解答	かいとう	kaitou	ответ; решение
回答	かいとう	kaitou	ответ
外部	がいぶ	gaibu	снаружи; внешний
解放	かいほう	kaihou	освобождение
開放	かいほう	kaihou	открытие
海洋	かいよう	kaiyou	океан
概論	がいろん	gairon	наброски; общие замечания
帰す	かえす	kaesu	отправлять обратно
却って	かえって	kaette	напротив; скорее; тем более; вместо
代える	かえる	kaeru	обменять; менять; заменять 
反る	かえる	kaeru	деформировать 
家屋	かおく	kaoku	дом; здание
係わる	かかわる	kakawaru	относиться к; иметь дело с; придерживаться (мнения)
書留	かきとめ	kakitome	регистрация
書取	かきとり	kakitori	диктант
垣根	かきね	kakine	ограда забор
掻く	かく	kaku	чесать; скрести
嗅ぐ	かぐ	kagu	нюхать 
架空	かくう	kakuu	подвесной; фантастический
各自	かくじ	kakuji	человек; каждый
拡充	かくじゅう	kakujuu	расширение
学術	がくじゅつ	gakujutsu	наука; обучение
各地	かくち	kakuchi	каждое место; различные места
拡張	かくちょう	kakuchou	расширение; расширение; увеличение; побег (ESC)
角度	かくど	kakudo	угол
学年	がくねん	gakunen	 класс в школе
学部	がくぶ	gakubu	факультет университета 
格別	かくべつ	kakubetsu	исключительный
確率	かくりつ	kakuritsu	вероятность
学力	がくりょく	gakuryoku	знания; способность
掛け算	かけざん	kakezan	умножение
可決	かけつ	kaketsu	утверждение; принятие (например законопроекта); прохождение
火口	かこう	kakou	кратер
下降	かこう	kakou	спуск; падение; погружение
重なる	かさなる	kasanaru	быть сложеным; накладываться друг на друга
重ねる	かさねる	kasaneru	накапливаться; копить; накладывать
飾り	かざり	kazari	украшение
火山	かざん	kazan	вулкан
	かしこまりました	kashikomarimashita	слушаюсь
貸し出し	かしだし	kashidashi	кредитование
過失	かしつ	kashitsu	ошибка; несчастный случай
果実	かじつ	kajitsu	фрукты; орехи; ягоды 
貸間	かしま	kashima	комната в аренду
貸家	かしや	kashiya	дом в аренду
個所	かしょ	kasho	место; пункт; участок
過剰	かじょう	kajou	избыток; чрезмерно
	かじる	kajiru	жевать; кусать; грызть; 
課税	かぜい	kazei	налогообложение
下線	かせん	kasen	подчеркивание; 
	カセット	kasetto	кассета 
加速	かそく	kasoku	ускорение
加速度	かそくど	kasokudo	ускорение
固い	かたい	katai	упрямый; твердый
堅い	かたい	katai	твёрдый; крепкий
片仮名	かたかな	katakana	катакана
片付く	かたづく	katazuku	привести в порядок; избавиться от 
塊	かたまり	katamari	масса; ком
固まる	かたまる	katamaru	затвердевать; укреплять; придавать форму
片道	かたみち	katamichi	в одну сторону 
傾く	かたむく	katamuku	склонить к 
片寄る	かたよる	katayoru	откладывать (отодвигать) в сторону
学科	がっか	gakka	курс обучения
学会	がっかい	gakkai	научное общество; академическая конференция
楽器	がっき	gakki	музыкальный инструмент
学級	がっきゅう	gakkyuu	класс в школе
担ぐ	かつぐ	katsugu	чтобы нести на плече
括弧	かっこ	kakko	скобка
活字	かつじ	katsuji	шрифт
活躍	かつやく	katsuyaku	деятельность
活力	かつりょく	katsuryoku	жизнеспособность; энергия
仮定	かてい	katei	предположение; предположение; гипотеза
過程	かてい	katei	процесс
課程	かてい	katei	учебная программа
仮名	かな	kana	псевдоним
仮名遣い	かなづかい	kanazukai	кана; слоговое написание
鐘	かね	kane	колокол
加熱	かねつ	kanetsu	отопление
兼ねる	かねる	kaneru	совмещать; соединять в себе
	カバー	kabaa	крышка; покрытие
過半数	かはんすう	kahansuu	большинство
被せる	かぶせる	kabuseru	покрывать
釜	かま	kama	чугунок; чайник
紙屑	かみくず	kamikuzu	макулатура
神様	かみさま	kamisama	бог
剃刀	かみそり	kamisori	бритва
	ガム	gamu	жевательная резинка
貨物	かもつ	kamotsu	груз
	かゆい	kayui	зуд 
歌謡	かよう	kayou	песня; баллада
殻	から	kara	оболочка; шелуха 
	カラー	karaa	воротник; цвет; цвет
	からかう	karakau	дразнить; подтрунивать; высмеять
空っぽ	からっぽ	karappo	пустой; полый
	かるた	karuta	 игральные карты
枯れる	かれる	kareru	увядать 
	カロリー	karorii	калория
	かわいがる	kawaigaru	любить; баловать
乾かす	かわかす	kawakasu	высушивать
渇く	かわく	kawaku	хотеть пить
為替	かわせ	kawase	денежный перевод; обмен
瓦	かわら	kawara	черепица
代る	かわる	kawaru	заменять, замещать; сменять; приходить на смену
間隔	かんかく	kankaku	пространство; интервал 
換気	かんき	kanki	вентиляция
感激	かんげき	kangeki	глубокие эмоции; впечатления; вдохновение
関西	かんさい	kansai	Кансай
鑑賞	かんしょう	kanshou	оценка
感ずる	かんずる	kanzuru	чувствовать; ощущать
間接	かんせつ	kansetsu	косвенность
乾燥	かんそう	kansou	сухой; засушливый; обезвоженной
感想	かんそう	kansou	впечатления; мысли
観測	かんそく	kansoku	наблюдение
寒帯	かんたい	kantai	арктическая зона
官庁	かんちょう	kanchou	органы правительства
勘違い	かんちがい	kanchigai	недоразумение; неправильное предположение
缶詰	かんづめ	kanzume	консервы; консервная банка
乾電池	かんでんち	kandenchi	сухой элемент; аккумулятор
関東	かんとう	kantou	Восточная половина Японии; в том числе Токио
観念	かんねん	kannen	идея; понятие; концепция; чувство (например, долга)
乾杯	かんぱい	kanpai	тост 
看板	かんばん	kanban	знак; вывеска; плакат
看病	かんびょう	kanbyou	выписка (пациента)
冠	かんむり	kanmuri	корона; диадема 
漢和	かんわ	kanwa	китайско-японский
気圧	きあつ	kiatsu	атмосферное давление
器械	きかい	kikai	инструмент
着替え	きがえ	kigae	переодевание; смена одежды
機関車	きかんしゃ	kikansha	локомотив; двигатель
飢饉	ききん	kikin	голод
器具	きぐ	kigu	принадлежности; инструменты; аппаратура; утварь
期限	きげん	kigen	термин; период
記号	きごう	kigou	символ; код
刻む	きざむ	kizamu	рубить; вырезать; гравировать
儀式	ぎしき	gishiki	церемония; обряд; ритуал; обслуживание
基準/規準	きじゅん	kijun	стандарт; основа; критерии; нормы
起床	きしょう	kishou	вставать (с постели); подниматься
着せる	きせる	kiseru	надевать одежду
基礎	きそ	kiso	фундамент; основа
気体	きたい	kitai	пар; газ
基地	きち	kichi	база
	きっかけ	kikkake	случай; возможность; предлог
	ぎっしり	gisshiri	плотно; полностью
基盤	きばん	kiban	фундамент; основа
客席	きゃくせき	kyakuseki	место гостя
客間	きゃくま	kyakuma	зал; комната для гостей
	ギャング	gyangu	банда
	キャンパス	kyanpasu	кампус
休業	きゅうぎょう	kyuugyou	закрыто (вывеска в магазине) 
休講	きゅうこう	kyuukou	лекции отменены
休息	きゅうそく	kyuusoku	отдых; передышка
給与	きゅうよ	kyuuyo	оплата; жалование; пособие по безработице; паёк
休養	きゅうよう	kyuuyou	отдых; перерыв 
清い	きよい	kiyoi	ясно; чисто; благородно
強化	きょうか	kyouka	усилить; активизировать; укрепить
境界	きょうかい	kyoukai	граница
行事	ぎょうじ	gyouji	мероприятие; функция
恐縮	きょうしゅく	kyoushuku	быть смущённым (тронутым, благодарным)
教養	きょうよう	kyouyou	культура; образование; воспитание
行列	ぎょうれつ	gyouretsu	 линия; шествие; матрица (математика)
漁業	ぎょぎょう	gyogyou	рыболовля (промышленность)
曲線	きょくせん	kyokusen	кривая
規律	きりつ	kiritsu	порядок; правила; закон
斬る	きる	kiru	обезглавливать
気を付ける	きをつける	kiotsukeru	быть осторожными; обращать внимание; заботиться
金魚	きんぎょ	kingyo	золотая рыбка
区域	くいき	kuiki	пределы; граница; домен; зона; сфера; территория
偶数	ぐうすう	guusuu	четное число
空想	くうそう	kuusou	мечта; фантазия; воображение; видение
空中	くうちゅう	kuuchuu	небо; воздух
	クーラー	kuuraa	кондиционер
釘	くぎ	kugi	гвоздь
区切る	くぎる	kugiru	расставлять знаки препинания; делить на абзацы; делить (на части); разграничивать
櫛	くし	kushi	гребень
	くしゃみ	kushami	чихание
苦情	くじょう	kujou	жалоба; неприятности; возражение
苦心	くしん	kushin	боль; беда
屑	くず	kuzu	отходы; лом
崩す	くずす	kuzusu	уничтожить; снести; разрушиить
薬指	くすりゆび	kusuriyubi	безымянный палец
崩れる	くずれる	kuzureru	разрушаться; крошиться
砕く	くだく	kudaku	сломать; разбить
砕ける	くだける	kudakeru	ломаться; нарушаться
	くたびれる	kutabireru	уставать; изнашиваться
	くだらない	kudaranai	 глупо; тривиально; ничего не стоит
下る	くだる	kudaru	спускаться
唇	くちびる	kuchibiru	губы
口紅	くちべに	kuchibeni	губная помада
	くっつく	kuttsuku	придерживаться; держаться ближе к
	くっつける	kuttsukeru	прилогать
	くどい	kudoi	многословный; назойливый; тяжелый на вкус
句読点	くとうてん	kutouten	знаки препинания
配る	くばる	kubaru	распространять; доставлять
工夫	くふう	kufuu	рабочий; работник
区分	くぶん	kubun	разделение; раздел; классификация
組合せ	くみあわせ	kumiawase	сочетание
組み立てる	くみたてる	kumitateru	собрать; установить; построить
汲む	くむ	kumu	черпать; вычерпывать; выкачивать
酌む	くむ	kumu	пить с кем-л.; понимать, входить в положение
悔しい	くやしい	kuyashii	досадный; прискорбный; обиднй
悔やむ	くやむ	kuyamu	сожалеть, раскаиваться
	クリーニング	kuriiningu	уборка; химчистка; прачечная
	くるむ	kurumu	くるむ
	くれぐれも	kureguremo	повторно, снова и снова; искренне 
	くわえる	kuwaeru	держать в зубах (во рту)
郡	ぐん	gun	уезд
稽古	けいこ	keiko	практика; обучение; исследование
敬語	けいご	keigo	вежливое слово или выражение; 
蛍光灯	けいこうとう	keikoutou	люминесцентная лампа 
形式	けいしき	keishiki	форма; формальность; формат; математическое выражение
継続	けいぞく	keizoku	продолжение
毛糸	けいと	keito	шерсть
経度	けいど	keido	долгота
系統	けいとう	keitou	cистема; геологическое древо
芸能	げいのう	geinou	общественного развлечения; достижения; навыки
競馬	けいば	keiba	скачки
警備	けいび	keibi	защита; охрана; безопасность
形容詞	けいようし	keiyoushi	предикативное прилагательное
形容動詞	けいようどうし	keiyoudoushi	полупредикативное прилагательное
外科	げか	geka	хирургическое отделение
毛皮	けがわ	kegawa	мех; кожа; шкура
激増	げきぞう	gekizou	внезапное увеличение
下車	げしゃ	gesha	высадка
下旬	げじゅん	gejun	 последняя треть месяца
下水	げすい	gesui	дренаж; канава; желоб; канализация
削る	けずる	kezuru	сокращать; строгать; скоблить; срезать
桁	けた	keta	брус, балка; столбец
下駄	げた	geta	гэта (японская обувь); деревянные башмаки
血圧	けつあつ	ketsuatsu	кровяное давление
血液	けつえき	ketsueki	кровь
月給	げっきゅう	gekkyuu	месячная зарплата
傑作	けっさく	kessaku	шедевр; лучшая работа 
月末	げつまつ	getsumatsu	конец месяца
気配	けはい	kehai	Индикация; тенденции рынка; беспокойство
下品	げひん	gehin	пошлость; подлость; непорядочность; грубость
煙い	けむい	kemui	дымчатый
蹴る	ける	keru	пнуть
けれど/けれども			но; тем не менее
険しい	けわしい	kewashii	обрывистый; крутой
見学	けんがく	kengaku	осмотр; экскурсия
謙虚	けんきょ	kenkyo	скромность; смирение
原稿	げんこう	genkou	рукопись
原産	げんさん	gensan	место происхождения; среда обитания
原始	げんし	genshi	происхождения; первобытный
研修	けんしゅう	kenshuu	обучение
厳重	げんじゅう	genjuu	строгий; тяжелый
謙遜	けんそん	kenson	смирение; скромность
県庁	けんちょう	kenchou	управление (власти) префектуры
限度	げんど	gendo	предел; границы
現に	げんに	genni	на самом деле; действительно
顕微鏡	けんびきょう	kenbikyou	микроскоп
原理	げんり	genri	принцип; теория; фундаментальная истина
原料	げんりょう	genryou	сырье
碁	ご	go	го (настольная игра)
恋しい	こいしい	koishii	 дорогой; любимый
請う	こう	kou	просить
工員	こういん	kouin	заводской рабочий
強引	ごういん	gouin	принуждение; напор; своеволие
公害	こうがい	kougai	загрязнение окружающей среды
高級	こうきゅう	koukyuu	высокий класс
公共	こうきょう	koukyou	государственный; общественный
工芸	こうげい	kougei	ремесло
孝行	こうこう	koukou	сыновий долг
交差	こうさ	kousa	пересечение
講師	こうし	koushi	преподаватель
工事	こうじ	kouji	строительные работы
公式	こうしき	koushiki	формула; формальность; официальный
口実	こうじつ	koujitsu	оправдание
	こうして	koushite	таким образом
校舎	こうしゃ	kousha	здание школы
公衆	こうしゅう	koushuu	общественность; народ
香水	こうすい	kousui	духи
公正	こうせい	kousei	справедливость; беспристрастность
功績	こうせき	kouseki	достижения; заслуги 
光線	こうせん	kousen	луч света
高層	こうそう	kousou	верхний
構造	こうぞう	kouzou	структура; строительство
交替	こうたい	koutai	чередование; смена; рельеф; реле; сдвиг
耕地	こうち	kouchi	пахотная земля
交通機関	こうつうきかん	koutsuukikan	транспортные средства
校庭	こうてい	koutei	школьный двор
肯定	こうてい	koutei	признание; утверждение
高度	こうど	koudo	высота над уровнем моря 
高等	こうとう	koutou	высокий класс
合同	ごうどう	goudou	сочетание; включение; союз; объединение
後輩	こうはい	kouhai	младший (на работе или в школе)
公表	こうひょう	kouhyou	официальный анонс; провозглашение
鉱物	こうぶつ	koubutsu	минерал
公務	こうむ	koumu	официальный бизнес; общественное бизнес
項目	こうもく	koumoku	пункт
紅葉	こうよう	kouyou	 (японский) клен
合理	ごうり	gouri	рациональный
交流	こうりゅう	kouryuu	переменный ток; общение; культурный обмен 
合流	ごうりゅう	gouryuu	стечение; союз
効力	こうりょく	kouryoku	эффект; эффективность; возможность
超える	こえる	koeru	превышать; пересекать
	コース	koosu	курс
	コーラス	koorasu	хор
焦がす	こがす	kogasu	гореть; жечь; опалить 
国王	こくおう	kokuou	король
国籍	こくせき	kokuseki	гражданство
国立	こくりつ	kokuritsu	национальный
	ごくろうさま	gokurousama	Спасибо вам большое за ваш ....
焦げる	こげる	kogeru	сжечь; подпаливать
凍える	こごえる	kogoeru	замерзать
心当たり	こころあたり	kokoroatari	идея
心得る	こころえる	kokoroeru	быть информированным; иметь глубокие знания
腰掛け	こしかけ	koshikake	сиденья; скамейки
腰掛ける	こしかける	koshikakeru	садиться
五十音	ごじゅうおん	gojuuon	японский алфавит
胡椒	こしょう	koshou	перец
	こしらえる	koshiraeru	делать; изготовить
超す	こす	kosu	пересечь; пройти; преодолеть 
擦る	こする	kosuru	тереть; растирать 
	ごぞんじですか	gozonjidesuka	(вежливо) а знаете, что
個体	こたい	kotai	индивидуальный
御馳走	ごちそう	gochisou	праздник; угощение
	ごちそうさま	gochisousama	праздник; угощение
	こちらこそ	kochirakoso	это я должен сказать об этом
小遣い	こづかい	kozukai	личные расходы; карманные деньги; непредвиденные расходы; пособие
	コック	kokku	 повар; кран 
	こっそり	kossori	украдкой; тайком
古典	こてん	koten	Старая книга; классика; классический
琴	こと	koto	Кото (японская арфа)
言付ける	ことづける	kotozukeru	отправить сообщение
言葉遣い	ことばづかい	kotobazukai	речь; выражение; формулировка
	こないだ	konaida	на днях; в последнее время; в последнее время
御無沙汰	ごぶさた	gobusata	молчать; долго не давать о себе знать
	こぼす	kobosu	проливать
	こぼれる	koboreru	переполнение; проливать
塵芥	ごみ	gomi	мусор
	ゴム	gomu	резинка; резина; ластик
御免	ごめん	gomen	прощения; разрешение
	ごめんください	gomenkudasai	Можно войти?; простите
小指	こゆび	koyubi	мизинец
	こらえる	koraeru	нести; стоять; терпеть; мириться с
娯楽	ごらく	goraku	удовольствие; развлечение
御覧	ごらん	goran	(вежл.) смотреть 
	コレクション	korekushon	 коррекция
転がす	ころがす	korogasu	свернуть
転がる	ころがる	korogaru	катиться; падать
紺	こん	kon	темно-синий 
	コンクール	konkuuru	конкурс 
	コンクリート	konkuriito	бетон
混合	こんごう	kongou	смешивание; смесь
	コンセント	konsento	 согласие; концентрация
献立	こんだて	kondate	меню; программа; расписание
	こんばんは	konbanha	добрый вечер
	サークル	saakuru	круг; спортивный клуб 
在学	ざいがく	zaigaku	поступить в школу
再三	さいさん	saisan	снова и снова; повторно
祭日	さいじつ	saijitsu	национальный праздник; день фестиваля
催促	さいそく	saisoku	Запрос; спрос; претензии; стремление 
採点	さいてん	saiten	маркировка; сортировка; смотреть на
災難	さいなん	sainan	бедствие; несчастье
裁縫	さいほう	saihou	шитье
材木	ざいもく	zaimoku	пиломатериал; лесоматериал
	サイレン	sairen	сирена
逆さ	さかさ	sakasa	реверс; инверсия; с ног на голову
逆様	さかさま	sakasama	реверс; инверсия; с ног на голову
捜す	さがす	sagasu	искать; искать
遡る	さかのぼる	sakanoboru	возвращаться; идти вверх по течению
酒場	さかば	sakaba	бар
	さきおととい	sakiototoi	позапозавчера
先程	さきほど	sakihodo	некоторое время назад
裂く	さく	saku	рвать; разрывать
索引	さくいん	sakuin	индекс
作者	さくしゃ	sakusha	автор; писатель
削除	さくじょ	sakujo	ликвидация; отмена; удаление; стирание
作成	さくせい	sakusei	составление; изготовление
作製	さくせい	sakusei	производство
探る	さぐる	saguru	искать; 
囁く	ささやく	sasayaku	шептать; бормотать
刺さる	ささる	sasaru	застревать
匙	さじ	saji	ложка
座敷	ざしき	zashiki	(застеленная татами) гостиная
差し支え	さしつかえ	sashitsukae	помеха; препятствие
差し引き	さしひき	sashihiki	вычет; вычитание; баланс; приливы и отливы; взлет и падение
刺身	さしみ	sashimi	нарезанная сырая рыба
刺す	さす	sasu	колоть; наносить удар; протыкать
挿す	さす	sasu	втыкать; вставлять; вкладывать
注す	さす	sasu	наливать
射す	さす	sasu	падать (о лучах света)
流石	さすが	sasuga	как можно было бы ожидать
撮影	さつえい	satsuei	фотосъемка
雑音	ざつおん	zatsuon	шум (сотрясение; решетка)
	さっさと	sassato	быстро
早速	さっそく	sassoku	сразу; немедленно; без задержек; быстро
錆	さび	sabi	ржавчина
錆びる	さびる	sabiru	ржаветь 
座布団	ざぶとん	zabuton	подушка (японская)
冷ます	さます	samasu	охлаждать; чтобы ослаблять 
妨げる	さまたげる	samatageru	мешать; предотвращать
冷める	さめる	sameru	охлаждаться; стихать; спадать
再来月	さらいげつ	saraigetsu	месяц после следующего
再来週	さらいしゅう	saraishuu	неделя после следующей
再来年	さらいねん	sarainen	год после следующего
	サラリーマン	sarariiman	сотрудник компании
騒がしい	さわがしい	sawagashii	шумный
	さわやか	sawayaka	свежий; освежающий; бодрящий
三角	さんかく	sankaku	треугольник; 
算数	さんすう	sansuu	арифметика
酸性	さんせい	sansei	кислотность
産地	さんち	sanchi	место пргоизводства
	サンプル	sanpuru	образец
山林	さんりん	sanrin	горы и лес
仕上がる	しあがる	shiagaru	завершать
	しあさって	shiasatte	через два дня после завтра
	シーズン	shiizun	сезон
	シーツ	shiitsu	лист
寺院	じいん	jiin	храм
	しいんと（する）	shin(suru)	спокойно; тихо
自衛	じえい	jiei	самооборона
塩辛い	しおからい	shiokarai	соленый (вкус)
司会	しかい	shikai	председательствование
四角	しかく	shikaku	четырехугольный
四角い	しかくい	shikakui	четырехугольный
時間割	じかんわり	jikanwari	расписание; график
四季	しき	shiki	четыре сезона
敷地	しきち	shikichi	территория чего-л.; площадка; участок
至急	しきゅう	shikyuu	срочно; неотложно
敷く	しく	shiku	стелить; застилать; расстилать
茂る	しげる	shigeru	густо расти 
持参	じさん	jisan	приносить с собой
磁石	じしゃく	jishaku	магнит
四捨五入	ししゃごにゅう	shishagonyuu	округление до ближайшего целого
始終	しじゅう	shijuu	постоянно; от начала до конца
自習	じしゅう	jishuu	самообучение
静まる	しずまる	shizumaru	успокаиваться
姿勢	しせい	shisei	отношение; поза
自然科学	しぜんかがく	shizenkagaku	естествознание
時速	じそく	jisoku	скорость (в час)
子孫	しそん	shison	потомки; потомство 
死体	したい	shitai	труп
下書き	したがき	shitagaki	черновик
下町	したまち	shitamachi	старая часть города; торговые и увеселительные кварталы
自治	じち	jichi	самоуправление; автономия
実感	じっかん	jikkan	реальное переживание; живое ощущение
湿気	しっけ/しっき	shikke/shikki	влага; влажность; сырость
	しつこい	shitsukoi	настойчивый; упрямый
実習	じっしゅう	jisshuu	практика; обучение
実績	じっせき	jisseki	достижения; результаты
湿度	しつど	shitsudo	уровень влажности
執筆	しっぴつ	shippitsu	письмо
実物	じつぶつ	jitsubutsu	настоящая вещь; оригинальный
	しっぽ	shippo	хвост (животное)
実用	じつよう	jitsuyou	практическое применение 
実力	じつりょく	jitsuryoku	заслуга; эффективность 
実例	じつれい	jitsurei	пример; иллюстрация
失恋	しつれん	shitsuren	разбитое сердце; безответная любовь 
指定	してい	shitei	обозначение; спецификация; назначение 
私鉄	してつ	shitetsu	частная железная дорога
児童	じどう	jidou	дети; несовершеннолетние
縛る	しばる	shibaru	связывать
地盤	じばん	jiban	земля
	しびれる	shibireru	затекать; неметь
紙幣	しへい	shihei	бумажные деньги; векселя 
	しぼむ	shibomu	чахнуть; увядать; высыхать; слабеть
絞る	しぼる	shiboru	выдавливать; выжимать
縞	しま	shima	полоса
地味	じみ	jimi	простой
	しみじみ	shimijimi	остро; глубоко; сердечно
氏名	しめい	shimei	полное имя
締切り	しめきり	shimekiri	крайний срок (подачи заявок и т.п.); закрытие 
締め切る	しめきる	shimekiru	закрывать; прекращать
湿る	しめる	shimeru	быть влажным; намокать
	ジャーナリスト	jaanarisuto	журналист
社会科学	しゃかいかがく	shakaikagaku	общественные науки
	しゃがむ	shagamu	сидеть на корточках
蛇口	じゃぐち	jaguchi	кран
弱点	じゃくてん	jakuten	слабое место; слабость
車庫	しゃこ	shako	гараж; автомобиль сарай
車掌	しゃしょう	shashou	проводник поезда
写生	しゃせい	shasei	черчение; рисование с натуры
社説	しゃせつ	shasetsu	передовая (статья)
	しゃっくり	shakkuri	икота
	シャッター	shattaa	затвор
	しゃぶる	shaburu	сосать; жевать
車輪	しゃりん	sharin	колеса автомобиля
洒落	しゃれ	share	шутка; каламбур; острота
	じゃんけん	janken	игра камень-ножницы-бумага 
集会	しゅうかい	shuukai	собрание; митинг
住居	じゅうきょ	juukyo	жилище; дом; место жительства; адрес
集金	しゅうきん	shuukin	сбор денег
集合	しゅうごう	shuugou	собрание; митинг
習字	しゅうじ	shuuji	чистописание
修繕	しゅうぜん	shuuzen	ремонт; починка
重体	じゅうたい	juutai	тяжёлое состояние (о больном)
	じゅうたん/カーペット	juutan/kaapetto	ковер
終点	しゅうてん	shuuten	конечная остановка 
重点	じゅうてん	juuten	важный моменто; акцент
就任	しゅうにん	shuunin	инаугурация; вступление в должность
周辺	しゅうへん	shuuhen	окружность; окраина; окрестности; периферия
重役	じゅうやく	juuyaku	директор; высокая исполнительная должность
終了	しゅうりょう	shuuryou	конец; прекращение
重量	じゅうりょう	juuryou	 вес; боксер-тяжеловес
重力	じゅうりょく	juuryoku	вес
熟語	じゅくご	jukugo	идиома; идиоматические фразы; кандзи соединение
祝日	しゅくじつ	shukujitsu	национальный праздник
縮小	しゅくしょう	shukushou	сокращение; свертывание
受験	じゅけん	juken	прием экзамена
主語	しゅご	shugo	подлежащее
出勤	しゅっきん	shukkin	выход на работу
述語	じゅつご	jutsugo	предикат; сказуемое
出張	しゅっちょう	shucchou	официальный тур; командировка
寿命	じゅみょう	jumyou	продолжительность жизни
主役	しゅやく	shuyaku	ведущая роль; ведущий актер (актриса)
受話器	じゅわき	juwaki	трубка телефона
循環	じゅんかん	junkan	циркуляция; вращение; цикл
巡査	じゅんさ	junsa	полиция; полицейский
順々	じゅんじゅん	junjun	по очереди; в свою очередь
順序	じゅんじょ	junjo	последовательность; порядок
純情	じゅんじょう	junjou	чистое сердце; наивность; самоотверженная преданность
純粋	じゅんすい	junsui	чистый; настоящий; подлинный; несмешанный
消化	しょうか	shouka	пищеварение
小学生	しょうがくせい	shougakusei	класс школьник
	しょうがない	shouganai	ничего не поделаешь
将棋	しょうぎ	shougi	японские шахматы; сеги
蒸気	じょうき	jouki	пар
定規	じょうぎ	jougi	линейка; обр. стандарт
上級	じょうきゅう	joukyuu	продвинутый уровень; высокий класс; старший
商業	しょうぎょう	shougyou	коммерция; торговля; бизнес
消極的	しょうきょくてき	shoukyokuteki	пассивный
賞金	しょうきん	shoukin	приз; денежная премия
上下	じょうげ	jouge	высокое и низкое; вверх и вниз; разгрузка и погрузка
障子	しょうじ	shouji	сёдзи (раздвижные перегородки в яп. доме)
商社	しょうしゃ	shousha	торговая компания; фирма
乗車	じょうしゃ	jousha	посадка на поезд
上旬	じょうじゅん	joujun	первые 10 дней месяца
生ずる	しょうずる	shouzuru	вызвать; возникать 
小数	しょうすう	shousuu	доля (часть); десятичной
商店	しょうてん	shouten	магазин; торговая фирма
焦点	しょうてん	shouten	фокус; точка
消毒	しょうどく	shoudoku	дезинфекции; стерилизация
勝敗	しょうはい	shouhai	победа или поражение 
蒸発	じょうはつ	jouhatsu	испарение; исчезновение
賞品	しょうひん	shouhin	приз; трофей
勝負	しょうぶ	shoubu	победа или поражение; матч; конкурс; игра; бой
小便	しょうべん	shouben	моча
消防署	しょうぼうしょ	shoubousho	пожарное депо
正味	しょうみ	shoumi	вес нетто 
正面	しょうめん	shoumen	передняя; честность
消耗	しょうもう	shoumou	истощение; расходование; износ
醤油	しょうゆ	shouyu	соевый соус
省略	しょうりゃく	shouryaku	аббревиатура; сокращенние
初級	しょきゅう	shokyuu	начальный уровень
助教授	じょきょうじゅ	jokyouju	доцент
食塩	しょくえん	shokuen	столовая соль
職人	しょくにん	shokunin	рабочий; механик; ремесленник; мастер
初旬	しょじゅん	shojun	первые 10 дней месяца
書籍	しょせき	shoseki	книга; издание
食器	しょっき	shokki	посуда
	ショップ	shoppu	магазин
書店	しょてん	shoten	книжный магазин
書道	しょどう	shodou	каллиграфия
白髪	しらが	shiraga	седые волосы 
知合い	しりあい	shiriai	знакомство
	シリーズ	shiriizu	серия
私立	しりつ	shiritsu	частное (учреждение)
資料	しりょう	shiryou	материалы; сведения
汁	しる	shiru	сок; суп; бульон
素人	しろうと	shirouto	любитель; новичок
芯	しん	shin	ядро; сердце; фитиль 
新幹線	しんかんせん	shinkansen	сверхскоростной пассажирский экспресс 
真空	しんくう	shinkuu	вакуум; полый; пустой
信ずる	しんずる	shinzuru	верить; иметь доверие
心身	しんしん	shinshin	ум и тело
申請	しんせい	shinsei	заявление; просьба; ходатайство
人造	じんぞう	jinzou	синтетический; искусственный
寝台	しんだい	shindai	кровать; диван
診断	しんだん	shindan	диагностика
侵入	しんにゅう	shinnyuu	проникновение; вторжение; рейд; агрессия
人文科学	じんぶんかがく	jinbunkagaku	социальные науки; гуманитарные науки
人命	じんめい	jinmei	(человека) жизни
深夜	しんや	shinya	поздно вечером
森林	しんりん	shinrin	лес
親類	しんるい	shinrui	родственник
針路	しんろ	shinro	компас 
神話	しんわ	shinwa	Миф; легенда
酢	す	su	уксус
水産	すいさん	suisan	морские продукты; рыболовство
炊事	すいじ	suiji	приготовление пищи
水蒸気	すいじょうき	suijouki	водяной пар; пар
水素	すいそ	suiso	водород
垂直	すいちょく	suichoku	вертикальный; перпендикулярной
推定	すいてい	suitei	презумпция; предположение; оценка
水滴	すいてき	suiteki	капля воды
水筒	すいとう	suitou	фляжка
随筆	ずいひつ	zuihitsu	эссе; различные сочинения
水分	すいぶん	suibun	влажность
水平	すいへい	suihei	уровень воды; горизонт
水平線	すいへいせん	suiheisen	горизонт
水曜	すいよう	suiyou	среда
	ずうずうしい	zuuzuushii	наглый; бесстыдный
	ずうっと	zuutto	все время; вплоть; прямо; полностью
末っ子	すえっこ	suekko	младший ребенок
	スカーフ	sukaafu	шарф
図鑑	ずかん	zukan	книжка с картинками
杉	すぎ	sugi	японский кедр
好き嫌い	すききらい	sukikirai	симпатии и антипатии; вкус
好き好き	すきずき	sukizuki	дело вкуса
透き通る	すきとおる	sukitooru	 пройти; просочиться; прозрачный
隙間	すきま	sukima	щель; трещина; разрыв 
	スクール	sukuuru	школа
	すくなくとも	sukunakutomo	по крайней мере
図形	ずけい	zukei	фигура
	スケジュール	sukejuuru	график
鈴	すず	suzu	колокол
涼む	すずむ	suzumu	охлаждать; остывать 
	スタート	sutaato	начало
	スチュワーデス	suchuwaadesu	стюардесса
	すっきり	sukkiri	стройно; четко; конкретно
	すっぱい	suppai	кислый; кислота
	ステージ	suteeji	 этап; производительность
棄てる	すてる	suteru	выбрасывть
	ストッキング	sutokkingu	чулки
	ストップ	sutoppu	стоп
素直	すなお	sunao	послушный; кроткий
頭脳	ずのう	zunou	голова; мозги; интеллект
	スピーカー	supiikaa	спикер
図表	ずひょう	zuhyou	диаграмма; схема; графика
	スマート	sumaato	умный; стильный; тонкий
住まい	すまい	sumai	жилище; дом; места жительства; адрес
	すまない	sumanai	жаль (фраза)
墨	すみ	sumi	чернила
澄む(清む)	澄む(清む)	sumu	очистить (например погоду); чтобы стать прозрачной
相撲	すもう	sumou	борьба сумо
	スライド	suraido	слайд
	ずらす	zurasu	откладывать; отложить
	ずらり	zurari	в ряд
掏摸	すり	suri	карманник
刷る	する	suru	в печати
狡い	ずるい	zurui	хитрый
	すれちがう	surechigau	пройти мимо друг друга; не согласиться
滑れる	ずれる	zureru	скользкий
寸法	すんぽう	sunpou	измерение; размер; размерность
姓	せい	sei	фамилия
税関	ぜいかん	zeikan	таможня
製作	せいさく	seisaku	изготовление; производство
制作	せいさく	seisaku	работа (фильм, книга)
性質	せいしつ	seishitsu	природа; характер
清書	せいしょ	seisho	чистовик
青少年	せいしょうねん	seishounen	молодежь; молодой человек
整数	せいすう	seisuu	целое
清掃	せいそう	seisou	уборка
生存	せいぞん	seizon	cуществование; бытие; выживание
生長	せいちょう	seichou	рост; прирост
政党	せいとう	seitou	политическая партия
生年月日	せいねんがっぴ	seinengappi	дата рождения
性能	せいのう	seinou	способность; эффективность
整備	せいび	seibi	регулировка; завершение; консолидация
成分	せいぶん	seibun	ингредиенты; состав
性別	せいべつ	seibetsu	различие по полу
正方形	せいほうけい	seihoukei	площадь
正門	せいもん	seimon	главные ворота; главный вход
成立	せいりつ	seiritsu	вступления в существовании; договоренностей; учреждения; завершения
西暦	せいれき	seireki	христианская эра; н.э.
背負う	せおう	seou	быть обремененным; проводить на спине или плече
赤道	せきどう	sekidou	экватор
折角	せっかく	sekkaku	с неприятности; на большие усилия; долгожданная
接近	せっきん	sekkin	все ближе; приближение
石鹸	せっけん	sekken	мыло
接する	せっする	sessuru	войти в контакт с 
	せっせと	sesseto	тяжело; старательно; усердно
接続	せつぞく	setsuzoku	соединение; союз; объединение
瀬戸物	せともの	setomono	фаянс; фарфор
	ぜひとも	zehitomo	всеми средствами (с чувством не принимая никаких за ответ)
迫る	せまる	semaru	приблизиться; нажать
	ゼミ	zemi	семинар
	せめて	semete	преступление; метод атаки
攻める	せめる	semeru	атаковать; штурмовать
	セメント	semento	цемент
栓	せん	sen	пробка; пробковые; краны
前後	ぜんご	zengo	вокруг; повсюду; спереди и сзади; спереди и сзади; до и после
洗剤	せんざい	senzai	моющее средство; стиральная материал
全集	ぜんしゅう	zenshuu	полное собрание сочинений
全身	ぜんしん	zenshin	все тело; полнометражные (портрет)
扇子	せんす	sensu	складной веер
専制	せんせい	sensei	деспотизм; самодержавие
先々月	せんせんげつ	sensengetsu	позапрошлый месяц 
先々週	せんせんしゅう	sensenshuu	позапрошлая неделя
先祖	せんぞ	senzo	предок
先端	せんたん	sentan	заостренный конец; наконечник; тонкий момент
	センチ	senchi	см; санти -; 0,1
宣伝	せんでん	senden	пропаганда; реклама
先頭	せんとう	sentou	главенство; лидерство
全般	ぜんぱん	zenpan	универсальный; полностью; вообще
扇風機	せんぷうき	senpuuki	электрический вентилятор
線路	せんろ	senro	линия; трек; дорожное полотно
相違	そうい	soui	разница; расхождение; изменение
	そういえば	souieba	так сказать...
雑巾	ぞうきん	zoukin	тряпка для уборки
増減	ぞうげん	zougen	увеличение и уменьшение; колебание
倉庫	そうこ	souko	склад; 
相互	そうご	sougo	взаимность
創作	そうさく	sousaku	производство; литературное творчество; работа
葬式	そうしき	soushiki	похороны
	そうして	soushite	и; как и
造船	ぞうせん	zousen	судостроение
騒々しい	そうぞうしい	souzoushii	шумно; неистово
増大	ぞうだい	zoudai	расширение
	そうっと	soutto	мягко; тихо; тайно
送別	そうべつ	soubetsu	проводы
草履	ぞうり	zouri	соломенные сандалии
総理大臣	そうりだいじん	souridaijin	премьер-министр
送料	そうりょう	souryou	доставка; перевозка
属する	ぞくする	zokusuru	принадлежать; попасть под 
続々	ぞくぞく	zokuzoku	последовательно; один за другим
速達	そくたつ	sokutatsu	экспресс; срочная доставка
測定	そくてい	sokutei	измерение
測量	そくりょう	sokuryou	измерение; съемка
速力	そくりょく	sokuryoku	скорость
素質	そしつ	soshitsu	характер; качества 
祖先	そせん	sosen	предок
	そそっかしい	sosokkashii	небрежный; бездумный
卒直	そっちょく	socchoku	откровенность; искренность 
具える	そなえる	sonaeru	быть оборудованым
	そのうえ	sonoue	кроме того
	そのころ	sonokoro	тогда; в то время
	そのため	sonotame	таким образом; по этой причине
	そのほか	sonohoka	в противном случае
蕎麦	そば	soba	соба (гречневая лапша)
剃る	そる	soru	брить
	それなのに	sorenanoni	но; не смотря на то, что
逸れる	それる	soreru	отклоняться; заблудиться; сбиться с пути
揃う	そろう	sorou	стать полным, равным 
揃える	そろえる	soroeru	наводить порядок; организовать; сформировать
算盤	そろばん	soroban	счеты
存じる/存ずる	ぞんじる/ぞんずる	zonjiru/ zonzuru	(вежливо) знать
損得	そんとく	sontoku	потери и выгоды; преимущества и недостатки
田ぼ	たんぼ	tanbo	рисовое поле
第一	だいいち	daiiichi	первый; в первую очередь; № 1
退院	たいいん	taiin	выписка из больницы
大学院	だいがくいん	daigakuin	аспирантура
大工	だいく	daiku	плотник
体系	たいけい	taikei	система; организация
太鼓	たいこ	taiko	барабан
対策	たいさく	taisaku	контрмеры
大して	たいして	taishite	(не очень) много; (не) очень
対照	たいしょう	taishou	контраст; антитеза; сравнение
大小	だいしょう	daishou	размер
体制	たいせい	taisei	порядок; система; структура; настройка; организация
体積	たいせき	taiseki	мощность; объем
大層	たいそう	taisou	очень; весьма; чрезвычайно
体操	たいそう	taisou	гимнастика; физические упражнения 
大分	だいぶん	daibun	значительно; много
大木	たいぼく	taiboku	большое дерево
題名	だいめい	daimei	название
代名詞	だいめいし	daimeishi	местоимение
	タイア	taia	шина
	ダイヤグラム	daiyaguramu	схема
	ダイヤモンド	daiyamondo	алмаз
	ダイヤル	daiyaru	циферблат
対立	たいりつ	tairitsu	противостояние; оппозиция; антагонизм
田植え	たうえ	taue	посадка риса
絶えず	たえず	taezu	постоянно
楕円	だえん	daen	эллипс
高める	たかめる	takameru	поднять; повысить
耕す	たがやす	tagayasu	пахать; культивировать
滝	たき	taki	водопад
炊く	たく	taku	готовить (пищу); варить
焚く	たく	taku	разжечь; развести огонь
蓄える	たくわえる	takuwaeru	хранить
竹	たけ	take	бамбук; средний (в системах трехуровневого рейтинга)
助かる	たすかる	tasukaru	спастись; выжить; быть подмогой
只	ただ	tada	просто; только; 
但し	ただし	tadashi	но; однако; при условии; что
畳む	たたむ	tatamu	сложить (одежду)
立ち止まる	たちどまる	tachidomaru	останавливаться
	たちまち	tachimachi	сразу; в один миг; вдруг; все сразу
建つ	たつ	tatsu	возводить; строить
発つ	たつ	tatsu	отправиться (о самолете; поезде и т.д.)
脱線	だっせん	dassen	сход с рельс; отступление
妥当	だとう	datou	действительно; собственно; не так ли; уместно
例える	たとえる	tatoeru	сравнивать; уподоблять; говорить образно;; использовать сравнение
頼もしい	たのもしい	tanomoshii	надежным; заслуживающим доверия; надежды; обещая
足袋	たび	tabi	таби; японские носки 
	ダブル	daburu	двойной
	だます	damasu	обмануть 
溜まる	たまる	tamaru	собирать; копить
	ダム	damu	дамба
溜息	ためいき	tameiki	вздох
	ためらう	tamerau	медлить
溜める	ためる	tameru	копить 
	だらしない	darashinai	неряшливо; свободно; слабо
足る	たる	taru	быть достаточным 
段階	だんかい	dankai	градация; класс; этап
短期	たんき	tanki	короткий срок
炭鉱	たんこう	tankou	угольная шахта 
短所	たんしょ	tansho	 дефект; слабое место; недостаток
	たんす	tansu	комод
淡水	たんすい	tansui	пресная вода
断水	だんすい	dansui	отключение воды
単数	たんすう	tansuu	единственное число
団地	だんち	danchi	многоквартирных квартиры
断定	だんてい	dantei	вывод; решение
短編	たんぺん	tanpen	короткий (например история, фильм)
誓う	ちかう	chikau	клясться, давать слово
地下水	ちかすい	chikasui	подземная вода
近々	ちかぢか	chikajika	близость; в скором времени
近付ける	ちかづける	chikazukeru	приблизиться 
近寄る	ちかよる	chikayoru	подходить; приближаться
力強い	ちからづよい	chikarazuyoi	обнадеживать 
	ちぎる	chigiru	клясться, обещать
地質	ちしつ	chishitsu	геологические особенности
知人	ちじん	chijin	друг; знакомый
地帯	ちたい	chitai	область; зона
縮む	ちぢむ	chijimu	сокращаться; сжиматься
縮める	ちぢめる	chijimeru	сократить; уменьшить; сжать
縮れる	ちぢれる	chijireru	мяться; завиваться
	チップ	chippu	чаевые; чип
地点	ちてん	chiten	сайт; точка на карте
地名	ちめい	chimei	разместить название
茶色い	ちゃいろい	chairoi	коричневый
着々	ちゃくちゃく	chakuchaku	неуклонно
茶碗	ちゃわん	chawan	чаша для риса 
中間	ちゅうかん	chuukan	средний; на полпути; промежуточный
中旬	ちゅうじゅん	chuujun	вторая треть месяца
抽象	ちゅうしょう	chuushou	абстрактный
中世	ちゅうせい	chuusei	cредневековье
中性	ちゅうせい	chuusei	средний род; нейтральный (хим.); равнодушие 
中途	ちゅうと	chuuto	на полпути
中年	ちゅうねん	chuunen	средних лет
超過	ちょうか	chouka	избыток 
彫刻	ちょうこく	choukoku	резьба; гравировка; скульптура
長所	ちょうしょ	chousho	 сильная сторона; заслуга; преимущество
長女	ちょうじょ	choujo	старшая дочь
調整	ちょうせい	chousei	регулирование; наладка; настройка
調節	ちょうせつ	chousetsu	регулирование; наладка; контроль
長短	ちょうたん	choutan	длина; длинные и короткие; +/ -
頂点	ちょうてん	chouten	высшая точка, вершина
長男	ちょうなん	chounan	старший сын
長方形	ちょうほうけい	chouhoukei	прямоугольник
調味料	ちょうみりょう	choumiryou	приправа 
	チョーク	chooku	мел
直後	ちょくご	chokugo	сразу после
直線	ちょくせん	chokusen	прямая линия
直前	ちょくぜん	chokuzen	прямо; вперед
直通	ちょくつう	chokutsuu	прямая связь
直流	ちょくりゅう	chokuryuu	постоянный ток
貯蔵	ちょぞう	chozou	хранение
直角	ちょっかく	chokkaku	прямой угол
直径	ちょっけい	chokkei	диаметр
散らかす	ちらかす	chirakasu	разбрасывать; раскидывать; оставлять в беспорядке
散らかる	ちらかる	chirakaru	быть разбросанным; быть в беспорядке
散らす	ちらす	chirasu	раскидывать; разбрасывать
塵紙	ちりがみ	chirigami	папиросная бумаги 
散る	ちる	chiru	падать; опадать; оцвести
追加	ついか	tsuika	добавка; дополнение
	ついで	tsuide	возможность; повод
通貨	つうか	tsuuka	валюта
通勤	つうきん	tsuukin	по дороге на работу
通ずる	つうずる	tsuuzuru	быть открытым (для движения); приводить к; течь; проходить через; пробиться к; сформировать связь
通知	つうち	tsuuchi	уведомления; извещения
通帳	つうちょう	tsuuchou	банковская книжка
通訳	つうやく	tsuuyaku	интерпретация; перевод
通用	つうよう	tsuuyou	популярное использование; тираж
通路	つうろ	tsuuro	проезд; путь
付合う	つきあう	tsukiau	связать с; чтобы держать компанию с; чтобы попасть на
突き当たり	つきあたり	tsukiatari	конец (например улицы)
突き当たる	つきあたる	tsukiataru	нарваться на; столкнуться с
月日	つきひ	tsukihi	время; годы; дни
点く	つく	tsuku	загораться; зажигаться
突く	つく	tsuku	 засунуть; ударять; ткнуть
次ぐ	つぐ	tsugu	ранжировать рядом; идти за
作る/造る	つくる	tsukuru	делать; создавать
着ける	つける	tsukeru	чтобы прикреплять; присоединитять; добавлять
点ける	つける	tsukeru	включить; чтобы осветить
浸ける	つける	tsukeru	вымачивать
伝わる	つたわる	tsutawaru	передаваться; распространяться
突っ込む	つっこむ	tsukkomu	окунуться в; чтобы идти в глубоко
務める	つとめる	tsutomeru	 служить; быть на должности; работать
綱	つな	tsuna	веревка
繋がり	つながり	tsunagari	соединение; связь; отношения
繋がる	つながる	tsunagaru	связать; подключать 
繋げる	つなげる	tsunageru	быть связанным
粒	つぶ	tsubu	зерно
潰す	つぶす	tsubusu	разбивать; ломать; тратить
潰れる	つぶれる	tsubureru	ломаться; разрушаться
	つまずく	tsumazuku	споткнуться, оступиться; сделать неверный шаг
詰まる	つまる	tsumaru	быть заблокированым; быть упакованым
積む	つむ	tsumu	нагромождать; наваливать
爪	つめ	tsume	ногти; копыта
艶	つや	tsuya	глянец; глазурь
強気	つよき	tsuyoki	сила
釣り合う	つりあう	tsuriau	балансировать; быть в гармонии; быть в соответствии
吊る/吊す	つる/つるす	tsuru/ tsurusu	повесить
出合い	であい	deai	встреча
手洗い	てあらい	tearai	уборная; туалет; умывальник
定員	ていいん	teiin	фиксированное количество штатного персонала; емкость 
定価	ていか	teika	установленая цена
低下	ていか	teika	падение; снижение; понижение; ухудшение
定期券	ていきけん	teikiken	сезонный (проездной) билет
定休日	ていきゅうび	teikyuubi	фиксированный нерабочий день
停止	ていし	teishi	прерывание; прекращение; запрет
停車	ていしゃ	teisha	остановка (например поезда)
停電	ていでん	teiden	отключение электроэнергии
出入り	でいり	deiri	доходы и расходы; дебет и кредит
出入口	でいりぐち	deiriguchi	выход и вход
手入れ	ていれ	teire	ремонт; техническое обслуживание
	テーマ	teema	тема
出掛ける	でかける	dekakeru	выходить; отправляться
出来上がり	できあがり	dekiagari	завершение, окончание (работы); качество работы 
出来上がる	できあがる	dekiagaru	 быть законченным; быть готовым; быть созданным для чего-л. (о врождённых качествах) 
的確/適確	てきかく	tekikaku	точный; четкий
手首	てくび	tekubi	запястье
凸凹	でこぼこ	dekoboko	неравномерность; шероховатость 
手頃	てごろ	tegoro	удобный; приемлемый; подходящий
	でたらめ	detarame	ерунда; бессмысленность
手帳	てちょう	techou	тетрадь; блокнот
鉄橋	てっきょう	tekkyou	железнодорожный мост; железный мост
手続き	てつづき	tetsuzuki	(юридический) процесс; формальности
鉄砲	てっぽう	teppou	пистолет
	テニスコート	tenisukooto	теннисный корт
手拭い	てぬぐい	tenugui	полотенце; носовой платок
手前	てまえ	temae	эта сторона
出迎え	でむかえ	demukae	встреча; прием
出迎える	でむかえる	demukaeru	встретиться; приветствовать
照らす	てらす	terasu	сиять; освещать
照る	てる	teru	сиять
展開	てんかい	tenkai	развёртывание; развитие
伝記	でんき	denki	биография; история жизни
電球	でんきゅう	denkyuu	лампочка
点数	てんすう	tensuu	знак; точка; оценка 
伝染	でんせん	densen	зараза
電池	でんち	denchi	батарея
点々	てんてん	tenten	тут и там; мало-помалу
転々	てんてん	tenten	переходить из рук в руки; переходить с места на место
電柱	でんちゅう	denchuu	телефонный столб; телеграфный столб 
天皇	てんのう	tennou	Император Японии
電波	でんぱ	denpa	электромагнитные волны
	テンポ	tenpo	темп
電流	でんりゅう	denryuu	электрический ток
電力	でんりょく	denryoku	электроэнергия
問い合わせ	といあわせ	toiawase	запрос
銅	どう	dou	медь
統一	とういつ	touitsu	единство; консолидация; однородность
同格	どうかく	doukaku	то же самое место в рейтинге; равенство; аппозиция
峠	とうげ	touge	гребень горы; трудная часть
統計	とうけい	toukei	рассеивание; дисперсия
動作	どうさ	dousa	действие; движение; поведение
東西	とうざい	touzai	восток и запад; вся страна
当日	とうじつ	toujitsu	назначенный день; в тот же день
投書	とうしょ	tousho	письмо от читателя 
登場	とうじょう	toujou	появление на сцене
	どうせ	douse	Так или иначе; в любом случае; по крайней мере
	どうぞよろしく	douzoyoroshiku	рад встретиться с вами
灯台	とうだい	toudai	маяк
盗難	とうなん	tounan	кража; грабеж
当番	とうばん	touban	при исполнении служебных обязанностей
等分	とうぶん	toubun	разделение на равные части
透明	とうめい	toumei	прозрачность; чистота
灯油	とうゆ	touyu	керосиновая лампа
東洋	とうよう	touyou	ориентировать
童話	どうわ	douwa	сказка
通り掛かる	とおりかかる	toorikakaru	проходить мимо
溶かす	とかす	tokasu	таять; растворяться
尖る	とがる	togaru	быть острым; заостряться
	どきどき	dokidoki	бится быстро
溶く	とく	toku	растворять (краску)
退く	どく	doku	 отступать
特殊	とくしゅ	tokushu	особый; неповторимый
特色	とくしょく	tokushoku	характеристика; особенности
特長	とくちょう	tokuchou	заслуга
特定	とくてい	tokutei	особый; особо установленный; специальный
特売	とくばい	tokubai	специальная распродажа
溶け込む	とけこむ	tokekomu	растворяться в
溶ける	とける	tokeru	таять; плавить; раствориться
退ける	どける	dokeru	устранять; исключать; убирать (с дороги)
床の間	とこのま	tokonoma	стенная ниша
床屋	とこや	tokoya	парикмахер
所々	ところどころ	tokorodokoro	тут и там; некоторые части (чего-то)
都心	としん	toshin	центр города 
戸棚	とだな	todana	шкаф; комод; шкаф для одежды
	とっくに	tokkuni	давно уже 
	どっと	dotto	вдруг
整う	ととのう	totonou	быть подготовленным; быть в порядке; быть организованым
留まる	とどまる	todomaru	быть закреплённым; держаться
	どなる	donaru	кричать; орать
飛び込む	とびこむ	tobikomu	прыгать в; окунуться в; нырять
跳ぶ	とぶ	tobu	прыгать; летать
留まる	とまる	tomaru	 для крепления; соблюдать; оставаться (в одном месте)
泊める	とめる	tomeru	давать приют 
	ともかく	tomokaku	во всяком случае; так или иначе; вообще говоря
捕える	とらえる	toraeru	ухватиться; схватить; поймать
取り入れる	とりいれる	toriireru	класть; убирать во что-л.; снимать урожай
取り消す	とりけす	torikesu	отменить
取り出す	とりだす	toridasu	вынуть; выбрать
採る	とる	toru	принять (меры , предложение); собирать (плоды)
捕る	とる	toru	хватать; ловить (рыбу); захватывать
	トレーニング	toreeningu	обучение
丼	どんぶり	donburi	чаша; миска
内科	ないか	naika	терапевт
内線	ないせん	naisen	внутренний телефон; добавочный номер
	ナイロン	nairon	нейлон
治す	なおす	naosu	 лечить; исправлять; чинить
永い	ながい	nagai	долгий
仲直り	なかなおり	nakanaori	примирение; мир с
長引く	ながびく	nagabiku	тянуть; тащить
中身/中味	なかみ	nakami	содержание; интерьер; вещество; заполнение; (меч) лезвие
中指	なかゆび	nakayubi	средний палец
仲良し	なかよし	nakayoshi	близкий друг; приятель
慰める	なぐさめる	nagusameru	утешить; успокоить
亡くす	なくす	nakusu	потерять кого-то 
	なぐる	naguru	ударять
為す	なす	nasu	выполнить; делать
謎謎	なぞなぞ	nazonazo	загадка; головоломка
傾らか	なだらか	nadaraka	нежно; легко
懐かしい	なつかしい	natsukashii	навевающий воспоминания
撫でる	なでる	naderu	гладить
斜め	ななめ	naname	диагональ; косая черта
	なにしろ	nanishiro	во всяком случае; так или иначе; во всяком случае; в любом случае
何々	なになに	naninani	что-что?
何分	なにぶん	nanibun	сколько минут ?
生意気	なまいき	namaiki	дерзкий; дерзкий; нахальный; наглый
並木	なみき	namiki	ряд деревьев
倣う	ならう	narau	подражать; следовать 
鳴らす	ならす	narasu	 звучать; звенеть; издавать звуки
生る	なる	naru	приносить свои плоды
馴れる	なれる	nareru	приучать; дрессировать
南極	なんきょく	nankyoku	Южный полюс; Антарктика
	なんとなく	nantonaku	так или иначе; для той или иной причине
	なんとも	nantomo	ничего (с отрицанием); вполне; не немного
	ナンバー	nanbaa	число
南米	なんべい	nanbei	Южная Америка
南北	なんぼく	nanboku	юг и север
煮える	にえる	nieru	варить
匂う	におう	niou	благоухать; пахнуть
逃がす	にがす	nigasu	выпускать на свободу
憎い	にくい	nikui	ненавистный; отвратительный 
憎む	にくむ	nikumu	ненавидеть 
憎らしい	にくらしい	nikurashii	ненавистный
	にこにこ	nikoniko	улыбаться
濁る	にごる	nigoru	помутниться
虹	にじ	niji	радуга
日時	にちじ	nichiji	дата и время
日用品	にちようひん	nichiyouhin	предметы первой необходимости
日課	にっか	nikka	ежедневная работа; распорядок дня
日程	にってい	nittei	повестка дня
鈍い	にぶい	nibui	тупой; тусклый; глупо
入社	にゅうしゃ	nyuusha	вход для компании
女房	にょうぼう	nyoubou	жена
睨む	にらむ	niramu	пронзить взглядом; следить за; держать под подозрением
煮る	にる	niru	до кипения; готовить
俄	にわか	niwaka	 внезапно; неожиданно; импровизационная сценка
縫う	ぬう	nuu	шить
濡らす	ぬらす	nurasu	мочить; впитывать; окунать
	ねじ	neji	винт
捩る	ねじる	nejiru	крутить
	ネックレス	nekkuresu	ожерелье
熱する	ねっする	nessuru	обогревать
寝間着/寝巻	ねまき	nemaki	ночное белье; пижама
狙い	ねらい	nerai	цель
狙う	ねらう	nerau	стремиться к
年度	ねんど	nendo	год; финансовый год; учебный год; срок
農産物	のうさんぶつ	nousanbutsu	сельскохозяйственная продукция
農村	のうそん	nouson	сельскохозяйственное сообщество; Деревня фермы; сельское
濃度	のうど	noudo	концентрация; яркость
農薬	のうやく	nouyaku	сельскохозяйственных химикаты
能率	のうりつ	nouritsu	эффективность
	のこぎり	nokogiri	пила
残らず	のこらず	nokorazu	все; целиком; полностью; без исключения
載せる	のせる	noseru	взять на борт; подвезти
覗く	のぞく	nozoku	заглядывать; подсматривать 
延ばす	のばす	nobasu	удлинить; растянуть; чтобы обратиться; отращивать
延びる	のびる	nobiru	быть продленым
上り	のぼり	nobori	поездка в Токио; восхождение
上る	のぼる	noboru	подниматься
糊	のり	nori	клейстер; клей; крахмал
乗換	のりかえ	norikae	пересадка транспорта
載る	のる	noru	лежать на чём-л.; быть погруженным
鈍い	のろい	noroi	медлительный; тупой; влюбчивый
	のろのろ	noronoro	медленно; вяло
呑気	のんき	nonki	беззаботность; небрежность; безрассудность
灰色	はいいろ	haiiro	серый; пепельный
俳句	はいく	haiku	поэзия хайку
拝見	はいけん	haiken	(скромно) смотреть, видеть
売店	ばいてん	baiten	магазин; стенд
	バイバイ	baibai	bye-bye
売買	ばいばい	baibai	торговля; покупка и продажа
這う	はう	hau	ползать 
生える	はえる	haeru	 расти; возникать
剥す	はがす	hagasu	шелушиться; сдирать
	ばからしい	bakarashii	абсурд
秤	はかり	hakari	весы
量る/測る	はかる	hakaru	измерить; взвесить 
吐き気	はきけ	hakike	тошнота; недомогание в желудке
	はきはき	hakihaki	доходчиво
掃く	はく	haku	подметать; чистить; собирать
歯車	はぐるま	haguruma	шестеренка
	バケツ	baketsu	ведро
挟まる	はさまる	hasamaru	быть пойманным; быть зажатым
挟む	はさむ	hasamu	ажимать с двух сторон; класть между чем-л.
箸	はし	hashi	палочки для еды
梯子	はしご	hashigo	лестница
始めに/初めに	はじめに	hajimeni	в первую очередь
	はじめまして	hajimemashite	рад встретиться с вами
斜	はす	hasu	косой; наклонный; диагональный
外れる	はずれる	hazureru	выключать; снимать; быть вне 
	パターン	pataan	шаблон
肌着	はだぎ	hadagi	нижнее белье
果して	はたして	hatashite	как и ожидалось; действительно
鉢	はち	hachi	миска; горшок
罰	ばつ	batsu	наказание
発揮	はっき	hakki	выставка; демонстрация 
	バック	bakku	назад
発射	はっしゃ	hassha	стрельба 
発想	はっそう	hassou	экспрессия; выразительность
発電	はつでん	hatsuden	выработка электроэнергии
発売	はつばい	hatsubai	продажа
派手	はで	hade	эффектный; громкий; кричащий; яркий
話合い	はなしあい	hanashiai	обсуждение
話し掛ける	はなしかける	hanashikakeru	обращаться к кому-л.
話中	はなしちゅう	hanashichuu	во время разговора; линия занята
甚だしい	はなはだしい	hanahadashii	чрезмерно; ужасно
花火	はなび	hanabi	фейерверк
花嫁	はなよめ	hanayome	невеста
放れる	はなれる	hanareru	отпускать
羽根	はね	hane	волан
	ばね	bane	пружина
跳ねる	はねる	haneru	прыгать
破片	はへん	hahen	фрагмент; осколок; обломок
歯磨き	はみがき	hamigaki	зубная паста
	はめる	hameru	надевать (перчатки, перстень и т.п.); вставлять, вкладывать; бросать (напр. в яму); наполнять
早口	はやくち	hayakuchi	быстро говорить
流行る	はやる	hayaru	процветать; процветать; быть популярным; прийти в моду
払い込む	はらいこむ	haraikomu	сдать на хранение; платить
払い戻す	はらいもどす	haraimodosu	погасить задолженность; погасить
	バランス	baransu	баланс
針金	はりがね	harigane	провод
張り切る	はりきる	harikiru	быть в приподнятом настроении; быть полным сил
反映	はんえい	hanei	отражение; влияние
半径	はんけい	hankei	радиус
判子	はんこ	hanko	печать (используется для подписи)
万歳	ばんざい	banzai	ура
判事	はんじ	hanji	судья
反省	はんせい	hansei	отражение; пересмотр; самоанализ; созерцание
番地	ばんち	banchi	номер дома; адрес
	パンツ	pantsu	трусы
	バンド	bando	полоса
半島	はんとう	hantou	полуостров
	ハンドル	handoru	ручка; руль
日当たり	ひあたり	hiatari	пребывание на солнце 
日帰り	ひがえり	higaeri	однодневная поездка
比較的	ひかくてき	hikakuteki	сравнительно; относительно
日陰	ひかげ	hikage	тень
	ぴかぴか	pikapika	сверкать; мигать
引受る	ひきうける	hikiukeru	предпринять; занять; взять на себя
引返す	ひきかえす	hikikaesu	повторять; отправить обратно; вернуть
引算	ひきざん	hikizan	вычитание
引出す	ひきだす	hikidasu	вытащить; вынуть; вытянуть; вывести
引き止める	ひきとめる	hikitomeru	задержать; проверить; сдерживать
卑怯	ひきょう	hikyou	трусость; подлость; несправедливость
引分け	ひきわけ	hikiwake	ничья (в конкурсе) 
髭	ひげ	hige	усы; борода 
陽射	ひざし	hizashi	солнечный свет; лучи солнца
肘	ひじ	hiji	локоть
	ピストル	pisutoru	пистолет
	ビタミン	bitamin	витамин
	ぴたり	pitari	вдруг; плотно (ぴったり); идеально (ぴったり)
引っ掛かる	ひっかかる	hikkakaru	попасть; застрять; быть обманутым
筆記	ひっき	hikki	записывание; записи
引っ繰り返す	ひっくりかえす	hikkurikaesu	перевернуть; опрокинуть; вывернуть наизнанку
引っ繰り返る	ひっくりかえる	hikkurikaeru	быть перевернутым; быть опрокинутым; быть вывернутым наизнанку
引越し	ひっこし	hikkoshi	изменение места жительства
引っ込む	ひっこむ	hikkomu	втягивать; впутывать; привлекать
筆者	ひっしゃ	hissha	писатель; автор
必需品	ひつじゅひん	hitsujuhin	необходимости
人差指	ひとさしゆび	hitosashiyubi	указательный палец
一通り	ひととおり	hitotoori	 обычно; в общем; кратко
人通り	ひとどおり	hitodoori	пешеход
	ひとまず	hitomazu	на время; пока что
瞳	ひとみ	hitomi	зрачки; глаза
一休み	ひとやすみ	hitoyasumi	передышка
独り言	ひとりごと	hitorigoto	монолог; разговор с самим собой
	ひとりでに	hitorideni	сам по себе; автоматически; естественно
	ビニール	biniiru	винил
皮肉	ひにく	hiniku	цинизм; сарказм
日日	ひにち	hinichi	каждый день; ежедневно; день за днем
捻る	ひねる	hineru	крутить, вертеть; закручивать
日の入り	ひのいり	hinoiri	закат
日の出	ひので	hinode	восход
響き	ひびき	hibiki	эхо; звук; звучание
響く	ひびく	hibiku	звучать
皮膚	ひふ	hifu	кожа
冷やす	ひやす	hiyasu	остыть; быть охлажденным
	ひゃっかじてん	hyakkajiten	энциклопедия
美容	びよう	biyou	красота 
表紙	ひょうし	hyoushi	обложка, переплёт
標識	ひょうしき	hyoushiki	знак 
標準	ひょうじゅん	hyoujun	стандарт; уровень
標本	ひょうほん	hyouhon	 образец
評論	ひょうろん	hyouron	критика
平仮名	ひらがな	hiragana	хирагана 
	ビルディング	birudingu	здание
昼寝	ひるね	hirune	дневной сон
広げる	ひろげる	hirogeru	распространяться; расширяться
広さ	ひろさ	hirosa	степень
広場	ひろば	hiroba	площадь
広々	ひろびろ	hirobiro	обширный; просторный
広める	ひろめる	hiromeru	расширить; распространить
	ピンク	pinku	розовый
便箋	びんせん	binsen	почтовая бумага
瓶詰	びんづめ	binzume	розлив в бутылки
	ファスナー	fasunaa	застежка; молния
風船	ふうせん	fuusen	воздушный шар
不運	ふうん	fuun	несчастье; неудача
殖える	ふえる	fueru	увеличивать; умножать
深まる	ふかまる	fukamaru	углубить; усилить; активизировать
不規則	ふきそく	fukisoku	неправильность; неустойчивость; беспорядок
普及	ふきゅう	fukyuu	диффузия; распространение
付近	ふきん	fukin	окрестности
拭く	ふく	fuku	протирать; высушивать
副詞	ふくし	fukushi	наречие
複写	ふくしゃ	fukusha	копия 
複数	ふくすう	fukusuu	множественное число; несколько
含める	ふくめる	fukumeru	включать; растолковывать
膨らます	ふくらます	fukuramasu	набухать; расширяться; чтобы раздуть; выпирать
膨らむ	ふくらむ	fukuramu	вздуваться; разбухать
不潔	ふけつ	fuketsu	нечистый; грязный 
更ける	ふける	fukeru	темнеть (о ночи); делаться поздней (об осени)
符号	ふごう	fugou	знак; символ
夫妻	ふさい	fusai	муж и жена; супружеская пара
塞がる	ふさがる	fusagaru	быть закрытым; быть перегороженным; быть заполненным; быть занятым
塞ぐ	ふさぐ	fusagu	закрывать; затыкать; преграждать
	ふざける	fuzakeru	говорить глупости; шутить
無沙汰	ぶさた	busata	молчать; долго не давать о себе знать
武士	ぶし	bushi	воин; самурай
部首	ぶしゅ	bushu	радикал иероглифа
襖	ふすま	fusuma	раздвижные экран
附属	ふぞく	fuzoku	прилагаться к чему-л.
蓋	ふた	futa	крышка; колпачок
不通	ふつう	futsuu	перерыв сообщения
	ぶつかる	butsukaru	столкнуться; врезаться
	ぶつける	butsukeru	швырять; ударять,
物騒	ぶっそう	bussou	опасно 
	ぶつぶつ	butsubutsu	ворчать; жаловаться 
船便	ふなびん	funabin	морская почта
部品	ぶひん	buhin	части; аксессуары
吹雪	ふぶき	fubuki	метель
父母	ふぼ	fubo	Отец и мать; родители
踏切	ふみきり	fumikiri	железнодорожный переезд; стартовая линия 
麓	ふもと	fumoto	подножие; основание горы 
増やす/殖やす	ふやす	fuyasu	увеличиваться; добавляться
	フライパン	furaipan	сковорода 
	ブラウス	burausu	блузка
	ぶらさげる	burasageru	вешать
	ブラシ	burashi	кисть
	プラスチック	purasuchikku	пластик
	プラットホーム	purattohoomu	платформа
	フリー	furii	бесплатно
振り仮名	ふりがな	furigana	фуригана (кана рядом с иероглифом, обозначающая чтение)
	プリント	purinto	печать; раздаточный материал
振舞う	ふるまう	furumau	манеры; поведение
	ブローチ	buroochi	брошь
	プログラム	puroguramu	программа
風呂敷	ふろしき	furoshiki	фуросики (цветной платок для завязывания в него вещей)
	ふわふわ	fuwafuwa	легкий; мягкий
噴火	ふんか	funka	извержение
分解	ぶんかい	bunkai	анализ; разбор
文芸	ぶんげい	bungei	литература; искусство и литература; художественная литература
文献	ぶんけん	bunken	литература; книги 
噴水	ふんすい	funsui	фонтан
分数	ぶんすう	bunsuu	деление (в математике)
文体	ぶんたい	buntai	литературный стиль
分布	ぶんぷ	bunpu	распределение
文房具	ぶんぼうぐ	bunbougu	канцтовары
文脈	ぶんみゃく	bunmyaku	контекст
分量	ぶんりょう	bunryou	сумма; количество
分類	ぶんるい	bunrui	классификация
閉会	へいかい	heikai	закрытие
平気	へいき	heiki	прохлада; спокойствие; хладнокровие; беспечность
並行	へいこう	heikou	идти рядом; идти плечом к плечу
平日	へいじつ	heijitsu	будние дни
兵隊	へいたい	heitai	солдат; моряк
平凡	へいぼん	heibon	обычный; посредственный
平野	へいや	heiya	открытое поле
凹む	へこむ	hekomu	вогнуться; осесть; поддаваться
	へそ	heso	пупок
隔てる	へだてる	hedateru	быть изгнаным
別荘	べっそう	bessou	дача
別々	べつべつ	betsubetsu	по отдельности; индивидуально
	ベテラン	beteran	ветеран
	ヘリコプター	herikoputaa	вертолет
	へる	heru	уменьшаться (в размере или количестве); спадать
	ぺん	pen	ручка
編集	へんしゅう	henshuu	редактирование; составление
便所	べんじょ	benjo	туалет; санузел
	ペンチ	penchi	плоскогубцы 
望遠鏡	ぼうえんきょう	bouenkyou	телескоп
方角	ほうがく	hougaku	направление; способ; 
箒	ほうき	houki	 метла
方言	ほうげん	hougen	диалект
坊さん	ぼうさん	bousan	буддистский священник; монах
防止	ぼうし	boushi	профилактика; проверка
方針	ほうしん	houshin	цель; план; политика
包装	ほうそう	housou	упаковка; 
法則	ほうそく	housoku	закон; правила
包帯	ほうたい	houtai	повязка; бинт
膨大	ぼうだい	boudai	огромный; громоздкий; широкий 
庖丁	ほうちょう	houchou	кухонный нож 
方程式	ほうていしき	houteishiki	уравнение
防犯	ぼうはん	bouhan	предотвращение совершения преступления
方面	ほうめん	houmen	направление; район; поле (например исследования)
坊や	ぼうや	bouya	мальчик
放る	ほうる	houru	отпустить
	ボーナス	boonasu	бонус
朗らか	ほがらか	hogaraka	яркость; жизнерадостность; весёлый; бодрый
牧場	ぼくじょう	bokujou	пастбище; скотоводческая ферма
牧畜	ぼくちく	bokuchiku	скотоводство
保健	ほけん	hoken	сохранение здоровья; гигиена; санитария
募集	ぼしゅう	boshuu	вербовка, призыв
干す	ほす	hosu	сушить; осушать
	ポスター	posutaa	плакат
北極	ほっきょく	hokkyoku	Северный полюс
坊っちゃん	ぼっちゃん	bocchan	сын (2-го или 3-го лица)
	ほどく	hodoku	отстегивать
堀	ほり	hori	ров; канал
掘る	ほる	horu	копать; 
彫る	ほる	horu	вырезать; гравировать; выдалбливать
	ぼろ	boro	тряпка; лом; потрепанные одежды 
盆	ぼん	bon	Бон (праздник поминовения предков)
盆地	ぼんち	bonchi	котловина; впадина; низина
本部	ほんぶ	honbu	штаб-квартира
本来	ほんらい	honrai	по существу; естественно; по своей природе
	まあまあ	maamaa	так себе
枚数	まいすう	maisuu	число страниц
毎度	まいど	maido	каждый раз; постоянно
	マイナス	mainasu	минус
巻く	まく	maku	сворачивать; заворачивать
蒔く	まく	maku	сеять (семена)
撒く	まく	maku	разбрасывать; посыпать; сеять
枕	まくら	makura	подушка
曲げる	まげる	mageru	сгибать; искривлять; наклонять
	まごまご	magomago	смущенный
摩擦	まさつ	masatsu	трение; обтирание 
混ざる/交ざる	まざる	mazaru	смешивать; присоединять
混じる/交じる	まじる	majiru	быть смешанным; присоединиться; находиться между
	マスク	masuku	маска
混ぜる/交ぜる	まぜる	mazeru	смешивать
	またぐ	matagu	оседлать
又は	または	mataha	или; в противном случае
待合室	まちあいしつ	machiaishitsu	зал ожидания
待ち合わせる	まちあわせる	machiawaseru	встречаться (условившись о встрече)
街角	まちかど	machikado	угол улицы
真っ暗	まっくら	makkura	полная темнота 
真っ黒	まっくろ	makkuro	черный как смоль
真っ青	まっさお	massao	синий; ужасно бледным
真っ先	まっさき	massaki	раньше всех; прежде всего
真っ白	まっしろ	masshiro	белоснежный
祭る	まつる	matsuru	обожествлять; поклоняться
窓口	まどぐち	madoguchi	касса
纏まる	まとまる	matomaru	быть улаженным; быть разрешенным; быть приведенным в порядок
纏める	まとめる	matomeru	улаживать; разрешать; приводить в порядок
真似る	まねる	maneru	имитировать; подражать
	まぶしい	mabushii	ослепительный; сияющий
	まぶた	mabuta	веки
	マフラー	mafuraa	шарф
間も無く	まもなく	mamonaku	в ближайшее время; до тех пор; в течение короткого времени
	マラソン	marason	марафон
円い	まるい	marui	круглые; круглые; сферические
稀	まれ	mare	редко; редко
回り道	まわりみち	mawarimichi	объезд
満員	まんいん	manin	полный дом; никакой вакансии; не проданы
	マンション	manshon	большая квартира; жилой дом
満点	まんてん	manten	высший балл
見送る	みおくる	miokuru	 провожать
見下ろす	みおろす	miorosu	не заметить; смотреть вниз на что-то
見掛け	みかけ	mikake	внешний вид
三日月	みかづき	mikazuki	новолуние; полумесяц
岬	みさき	misaki	мыс
	みじめ	mijime	жалкий; бедный; несчастный
	ミシン	mishin	швейная машина
店屋	みせや	miseya	магазин 
見出し	みだし	midashi	заголовок; подпись; субтитры
道順	みちじゅん	michijun	 маршрут
見付かる	みつかる	mitsukaru	можно найти; чтобы быть обнаружены
見付ける	みつける	mitsukeru	быть знакомым; чтобы обнаружить; выявить
	みっともない	mittomonai	стыдно; неприлично
見直す	みなおす	minaosu	пересмотр мнения
見慣れる	みなれる	minareru	привыкнуть видеть что-л.; стать знакомым с
醜い	みにくい	minikui	уродливый
実る	みのる	minoru	приносить свои плоды; созревать
身分	みぶん	mibun	социальное положение; социальный статус
見本	みほん	mihon	образец
見舞う	みまう	mimau	спросить о здоровье; посещать больного
未満	みまん	miman	меньше; недостаточно
名字	みょうじ	myouji	фамилия; имя семьи
	ミリ(メートル)	miri(meetoru)	милли; 0.001
診る	みる	miru	обследовать (медицинское)
民間	みんかん	minkan	гражданский; частный; негосударственный; неофициальный
民謡	みんよう	minyou	народная песня; популярная песня
向う	むかう	mukau	направляться к; идти навстречу
剥く	むく	muku	сдирать; обдирать; чистить; шелушить
無限	むげん	mugen	бесконечный
無地	むじ	muji	одноцветный; гладкий
蒸し暑い	むしあつい	mushiatsui	влажный; душный
矛盾	むじゅん	mujun	противоречие; несоответствие
蒸す	むす	musu	варить на пару; тушить; быть душным
無数	むすう	musuu	бесчисленное количество; бесконечное число
紫	むらさき	murasaki	фиолетовый
群れ	むれ	mure	группа; толпа; стадо
姪	めい	mei	племянница
名作	めいさく	meisaku	шедевр
名刺	めいし	meishi	визитная карточка
名詞	めいし	meishi	существительное
名所	めいしょ	meisho	известное место
命ずる	めいずる	meizuru	командовать; назначить
迷信	めいしん	meishin	суеверие
名物	めいぶつ	meibutsu	то, чем славится местность; достопримечательность
銘々	めいめい	meimei	каждый; индивидуальный
目上	めうえ	meue	превосходить; старший
	メーター	meetaa	метр 
恵まれる	めぐまれる	megumareru	быть благословленным 
巡る	めぐる	meguru	ходить
目指す	めざす	mezasu	нацеливаться на
目覚し	めざまし	mezamashi	(сокр) будильник
目下	めした	meshita	в настоящее время; теперь
目印	めじるし	mejirushi	знак; достопримечательность
目立つ	めだつ	medatsu	быть заметным; выделяться
	めちゃくちゃ	mechakucha	абсурдно; неразумно; чрезмерно
	めっきり	mekkiri	замечательно
	めでたい	medetai	счастливый; радостный; глуповатый
	メニュー	menyuu	меню
	めまい	memai	головокружение; 
目安	めやす	meyasu	критерий; цель
免税	めんぜい	menzei	освобождение от налогов; освобождение от пошлин
面積	めんせき	menseki	площадь
面接	めんせつ	mensetsu	интервью
面倒臭い	めんどうくさい	mendoukusai	утомительный
儲かる	もうかる	moukaru	быть прибыльным 
儲ける	もうける	moukeru	получить; заработать 
申し訳ない	もうしわけない	moushiwakenai	непростительный
	モーター	mootaa	двигатель
木材	もくざい	mokuzai	пиломатериал; лесоматериал; древесина
目次	もくじ	mokuji	оглавление
潜る	もぐる	moguru	нырять; залезать; прятаться
	もしかしたら/もしかすると	moshikashitara/ moshikasuruto	возможно; может быть; если вдруг
	もたれる	motareru	прислониться; опереться; откинуться на 
	モダン	modan	современный
餅	もち	mochi	рисовая лепешка
	もったいない	mottainai	расточительный; кощунственный; недостойный
	モデル	moderu	модель
元々	もともと	motomoto	первоначально; по своей природе; с самого начала
物置	ものおき	monooki	кладовая
物語る	ものがたる	monogataru	рассказ; история; легенда; сказка
物差し	ものさし	monosashi	мера
物凄い	ものすごい	monosugoi	из ряда вон выходящее; в очень большой степени
	モノレール	monoreeru	монорельс
紅葉	もみじ	momiji	 (японский) клен
揉む	もむ	momu	мять; комкать; тереть
燃やす	もやす	moyasu	сжигать
催し	もよおし	moyooshi	собрание; празднество
盛る	もる	moru	накладывать (напр. еду); прописывать (лекарство)
問答	もんどう	mondou	вопросы и ответы; диалог
	やかましい	yakamashii	 шумный; суетливый
夜間	やかん	yakan	В ночное время; ночное время
薬缶	やかん	yakan	чайник
役者	やくしゃ	yakusha	актер; актриса
役所	やくしょ	yakusho	аппарат правительства; государственные должности
訳す	やくす	yakusu	переводить (с иностранного языка)
役人	やくにん	yakunin	правительственный чиновник
薬品	やくひん	yakuhin	медицина
役目	やくめ	yakume	долг; бизнес
火傷	やけど	yakedo	ожоги
夜行	やこう	yakou	ночной поезд; ночная поездка
矢印	やじるし	yajirushi	стрелка (для указания направления)
	やたらに	yatarani	случайно; по неосторожности; слепо
薬局	やっきょく	yakkyoku	аптека
	やっつける	yattsukeru	атаковать; бить
家主	やぬし	yanushi	арендодатель
	やっぱり	yappari	Также; как я думал; по-прежнему; несмотря на; абсолютно; конечно
破く	やぶく	yabuku	разбивать; ломать; рвать; разрушать
破れる	やぶれる	yabureru	рватьтся; изнашиваться
	やむをえない	yamuoenai	ничего не поделаешь; неизбежно
軟らかい	やわらかい	yawarakai	мягкий; нежный
遊園地	ゆうえんち	yuuenchi	парк с аттракционами
夕刊	ゆうかん	yuukan	вечерняя газета
友好	ゆうこう	yuukou	дружба
郵送	ゆうそう	yuusou	отправка почтой
夕立	ゆうだち	yuudachi	(внезапный летний) ливень
夕日	ゆうひ	yuuhi	вечернее солнце; заходящее солнце
悠々	ゆうゆう	yuuyuu	тихий; спокойный; неторопливый
有料	ゆうりょう	yuuryou	платный
浴衣	ゆかた	yukata	 летнее кимоно; юката
湯気	ゆげ	yuge	пар
輸血	ゆけつ	yuketsu	переливание крови
輸送	ゆそう	yusou	транспорт; перевозки
油断	ゆだん	yudan	небрежность; неподготовленность
	ゆでる	yuderu	кипятить
湯飲み	ゆのみ	yunomi	чайная чашка
緩い	ゆるい	yurui	свободный; мягкий; медленный
溶岩	ようがん	yougan	лава
容器	ようき	youki	контейнер; судно
用語	ようご	yougo	термин; терминология
要旨	ようし	youshi	уяснение сути; кратко; основы
幼児	ようじ	youji	младенец; ребенок
容積	ようせき	youseki	мощность; объем
幼稚	ようち	youchi	младенчество; детский; инфантильный
幼稚園	ようちえん	youchien	детский сад
用途	ようと	youto	использование; полезность
洋品店	ようひんてん	youhinten	магазин одежды и аксессуаров (в западном стиле)
養分	ようぶん	youbun	питание; питательный
羊毛	ようもう	youmou	шерсть
漸く	ようやく	youyaku	постепенно; наконец
要領	ようりょう	youryou	точка; суть; предметы первой необходимости; план
欲張り	よくばり	yokubari	алчность; жадность 
余計	よけい	yokei	слишком много; изобилие; избыток 
	よこす	yokosu	посылать; направлять
汚す	よごす	yogosu	 опозорить; обесчестить; загрязнить 
寄せる	よせる	yoseru	собирать; добавить; отложить в сторону
余所	よそ	yoso	другое место; где-то еще
四つ角	よつかど	yotsukado	четыре угла; перекресток
酔っ払い	よっぱらい	yopparai	пьяница
予備	よび	yobi	подготовка; запас
呼び掛ける	よびかける	yobikakeru	окликнуть; приставать; обратиться
呼び出す	よびだす	yobidasu	 вызвать (например по телефону)
蘇る	よみがえる	yomigaeru	воскресать; оживать
因る	よる	yoru	исходить от
慶び	よろこび	yorokobi	 радость; восторг 
慶ぶ	よろこぶ	yorokobu	радоваться
来日	らいにち	rainichi	прибытие в Японию
落第	らくだい	rakudai	неудача на экзамене
	ラッシュアワー	rasshuawaa	час пик
欄	らん	ran	колонка текста (как в газете)
	ランチ	ranchi	 обед; ланч
	ランニング	ranningu	 бег
乱暴	らんぼう	ranbou	грубость; насилие; беспорядки
理科	りか	rika	наука
利害	りがい	rigai	преимущества и недостатки 
	リズム	rizumu	ритм
	リットル	rittoru	литровый
	リボン	ribon	лента
略す	りゃくす	ryakusu	укорачивать; сокращать
流域	りゅういき	ryuuiki	бассейн (реки)
寮	りょう	ryou	общежитие
両側	りょうがわ	ryougawa	обе стороны
漁師	りょうし	ryoushi	рыбак
領事	りょうじ	ryouji	консул
領収	りょうしゅう	ryoushuu	получение
臨時	りんじ	rinji	специальный; чрезвычайный
留守番	るすばん	rusuban	присмотр за домом (в отсутствие хозяев)
例外	れいがい	reigai	исключение
零点	れいてん	reiten	нулевая точка
冷凍	れいとう	reitou	замораживание; охлаждение
	レインコート	reinkooto	плащ
	レクリェーション	rekureeshon	отдых
	レジャー	rejaa	досуг
列島	れっとう	rettou	цепь островов
	レベル	reberu	уровень
	リポート	ripooto	отчет; бумага
煉瓦	れんが	renga	кирпич
連合	れんごう	rengou	союз; альянс
	レンズ	renzu	объектив
蝋燭	ろうそく	rousoku	свеча
	ローマじ	roomaji	ромадзи; латинские буквы
録音	ろくおん	rokuon	(аудио) записи
	ロッカー	rokkaa	ящик
	ロビー	robii	лобби
論ずる	ろんずる	ronzuru	спорить; обсуждать; дискутировать
和英	わえい	waei	Японско-английский
分る	わかる	wakaru	быть понятным
分かれる	わかれる	wakareru	ответвляться; расходиться с; быть расделенным
若々しい	わかわかしい	wakawakashii	молодой; 
湧く	わく	waku	бить (об источнике, фонтане); возникать, внезапно появляться
詫びる	わびる	wabiru	извиняться
和服	わふく	wafuku	японская одежда
	わりあいに	wariaini	сравнительно
割算	わりざん	warizan	деление (математика)
割と	わりと	warito	относительно
割引	わりびき	waribiki	скидка; снижение 
椀	わん	wan	чашка, пиала (деревянная или лаковая)
碗	わん	wan	чаша
	ワンピース	wanpiisu	цельное платье (в западном стиле)