	あっ	a	Ah!;Oh!
愛	あい	ai	love
挨拶	あいさつ	aisatsu	greeting;salutation
愛情	あいじょう	aijou	love;affection
合図	あいず	aizu	sign;signal
	アイスクリーム	aisukuriimu	ice cream
愛する	あいする	aisuru	to love
相手	あいて	aite	companion;partner;company
	あいにく	ainiku	unfortunately;Sorry; but....
	アイロン	airon	(electric) iron
	アウト	auto	out
明かり	あかり	akari	lamplight;light (in general);brightness
空き	あき	aki	room;time to spare;emptiness
明らか	あきらか	akiraka	obvious;evident;clear
諦める	あきらめる	akirameru	to give up;to abandon
飽きる	あきる	akiru	to get tired of;to lose interest in;to have enough
握手	あくしゅ	akushu	handshake
悪魔	あくま	akuma	devil;demon;evil spirit
明ける	あける	akeru	to dawn;to become daylight
	あした	ashita	tomorrow
預ける	あずける	azukeru	to give into custody;to entrust;to deposit
汗	あせ	ase	sweat;perspiration
与える	あたえる	ataeru	to give;to present;to award
暖かい	あたたか(い)	atataka(i)	warm;mild
辺り	あたり	atari	vicinity;nearby
当たる	あたる	ataru	to be hit;to be successful;to be equivalent to
	あちこち	achikochi	here and there
扱う	あつかう	atsukau	to handle;to deal with;to treat
集まり	あつまり	atsumari	gathering;meeting;assembly;collection
当てる	あてる	ateru	to hit;to apply a patch
跡	あと	ato	(1) trace;tracks;mark;sign;(2) remains;ruins;(3) scar
穴	あな	ana	hole
浴びる	あびる	abiru	to bathe;to bask in the sun;to shower
油	あぶら	abura	oil
余り	あまり	amari	not very (used as adverb);not much
誤り	あやまり	ayamari	error
粗	あら	ara	defect;flaw;blemish;weak point
嵐	あらし	arashi	storm;tempest
新た	あらた	arata	new;fresh;novel
	あらゆる	arayuru	all;every
表す	あらわす	arawasu	to express;to show;to reveal
現す	あらわす	arawasu	to show;to indicate;to display
現れ	あらわれ	araware	embodiment;materialization
現れる	あらわれる	arawareru	(1) to appear;to come in sight;to become visible;(2) to express oneself
有る	ある	aru	to be;to have
或	ある	aru	a certain...;some...
	あるいは	aruiha	or;possibly
	アルバム	arubamu	album
泡	あわ	awa	bubble;foam;froth;head on beer
合わせる	あわせる	awaseru	to join together;to be opposite;to face;to unite
哀れ	あわれ	aware	helpless;pity;sorrow;grief
案	あん	an	plan;suffix meaning draft
暗記	あんき	anki	memorization;learning by heart
安定	あんてい	antei	stability;equilibrium
案内	あんない	annai	information;guidance;leading
	あんなに	annani	to that extent;to that degree
	あんまり	anmari	not very;not much;remainder;rest
胃	い	i	stomach
	いい	ii	good
	よい	yoi	good;nice;pleasant;ok
いえ	いえ	ie	same as いいえ
委員	いいん	iin	committee member
言う	ゆう	yuu	to say
意外	いがい	igai	unexpected;surprising
行き	いき(ゆき)	iki (yuki)	going
息	いき	iki	breath;tone
勢い	いきおい	ikioi	force;vigor;energy;spirit
生き物	いきもの	ikimono	living thing;animal
幾つ	いくつ	ikutsu	how many?;how old?
幾ら	いくら	ikura	how much?;how many?
	いけない	ikenai	must not do;bad;wrong;not good
医師	いし	ishi	doctor;physician
意思	いし	ishi	intention;purpose
意志	いし	ishi	will;volition
維持	いじ	iji	maintenance;preservation
意識	いしき	ishiki	consciousness;senses
異常	いじょう	ijou	strangeness;abnormality;disorder
椅子	いす	isu	chair
泉	いずみ	izumi	spring;fountain
	いずれ	izure	where;which;who
以前	いぜん	izen	ago;since;before;previous
板	いた	ita	board;plank
偉大	いだい	idai	greatness
抱く	いだく	idaku	(sl) to embrace;to hug;to harbour;to entertain
	いたずら	itazura	tease;prank;trick;practical joke
	いただきます	itadakimasu	expression of gratitude before meals
頂く	いただく	itadaku	to receive;to take food or drink (hum)
痛み	いたみ	itami	pain;ache;sore;grief;distress
至る	いたる	itaru	to come;to arrive
	いち	ichi	market;fair
位置	いち	ichi	place;situation;position;location
一時	いちじ	ichiji	moment;time
一度に	いちどに	ichidoni	all at once
市場	いちば	ichiba	(the) market (as a concept)
一番	いちばん	ichiban	best;first;number one
	いつか	itsuka	sometime;someday;one day
一家	いっか	ikka	a house;a home;a family;a household
一種	いっしゅ	isshu	a species;a kind;a variety
一瞬	いっしゅん	isshun	a moment;an instant
一生	いっしょう	isshou	whole life;a lifetime;all through life
一層	いっそう	issou	much more;still more;all the more
一体	いったい	ittai	(1) one object;one body;(2) what on earth?;really?;(3) generally
一致	いっち	icchi	(1) coincidence;agreement;(2) conformity
	いつでも	itsudemo	(at) any time;always;at all times;never (neg)
一般	いっぱん	ippan	general;liberal;universal;ordinary;average
一方	いっぽう	ippou	(1) on the other hand;(2) meanwhile;(3) only;simple;in turn
	いつまでも	itsumademo	forever;for good;eternally;as long as one likes;indefinitely
いつも	いつも	itsumo	always;usually;every time;never (with neg. verb)
移動	いどう	idou	removal;migration;movement
従兄弟	いとこ	itoko	cousin (male)
稲	いね	ine	rice-plant
居眠り	いねむり	inemuri	dozing;nodding off
命	いのち	inochi	command;decree;life;destiny
違反	いはん	ihan	violation (of law);transgression;infringement;breach
衣服	いふく	ifuku	clothes
居間	いま	ima	living room (western style)
今に	いまに	imani	before long;even now
今にも	いまにも	imanimo	at any time;soon
否	いや	iya	no;the noes
以来	いらい	irai	since;henceforth
依頼	いらい	irai	(1) request;commission;dispatch;(2) dependence;trust
	いらいら	iraira	getting nervous;irritation
	いらっしゃい	irasshai	welcome
医療	いりょう	iryou	medical care;medical treatment
岩	いわ	iwa	rock;crag
祝い	いわい	iwai	celebration;festival
祝う	いわう	iwau	to congratulate;to celebrate
言わば	いわば	iwaba	so to speak
	いわゆる	iwayuru	the so-called;so to speak
	インク	inku	ink
印刷	いんさつ	insatsu	printing
印象	いんしょう	inshou	impression
引退	いんたい	intai	retire
引用	いんよう	inyou	quotation;citation
	ウイスキー	uisukii	whisky
上	うわ	uwa	upper;outer;surface
魚	うお	uo	fish
	うがい	ugai	gargle;rinse mouth
伺う	うかがう	ukagau	(hon) to visit;to ask;to inquire
受け取る	うけとる	uketoru	to receive;to get;to accept;to take
動かす	うごかす	ugokasu	to move;to shift
兎	うさぎ	usagi	rabbit;hare;cony
牛	うし	ushi	cattle;cow
失う	うしなう	ushinau	to lose;to part with
後	うしろ	ushiro	afterwards;since then;in the future
嘘	うそ	uso	lie;falsehood;incorrect fact;inappropriate
疑う	うたがう	utagau	to doubt;to distrust;to be suspicious of;to suspect
内	うち	uchi	inside
宇宙	うちゅう	uchuu	universe;cosmos;space
撃つ	うつ	utsu	to attack;to defeat;to destroy
移す	うつす	utsusu	to remove;to transfer;to infect
訴える	うったえる	uttaeru	to sue (a person);to resort to;to appeal to
	うなる	unaru	to groan;to moan
奪う	うばう	ubau	to snatch away
馬	うま	uma	(1) horse;(2) promoted bishop (shogi)
うまい	うまい	umai	delicious
生まれ	うまれ	umare	birth;birth-place
梅	うめ	ume	plum;plum-tree;lowest (of a three-tier ranking system)
裏切る	うらぎる	uragiru	to betray;to turn traitor to;to double-cross
	うるさい	urusai	noisy;loud;fussy
嬉しい	うれしい	ureshii	happy;glad;pleasant
売れる	うれる	ureru	to be sold
噂	うわさ	uwasa	rumour;report;gossip;common talk
運	うん	un	fortune;luck
運転	うんてん	unten	operation;motion;driving
運動	うんどう	undou	motion;exercise
柄	え	e	handle;grip
永遠	えいえん	eien	eternity;perpetuity;immortality;permanence
永久	えいきゅう	eikyuu	eternity;perpetuity;immortality
影響	えいきょう	eikyou	influence;effect
営業	えいぎょう	eigyou	business;trade;management
衛星	えいせい	eisei	satellite
栄養	えいよう	eiyou	nutrition;nourishment
笑顔	えがお	egao	smiling face
描く	えがく	egaku	to draw;to paint;to sketch;to depict;to describe
餌	えさ	esa	feed;bait
	エネルギー	enerugii	(n) energy (de; Energie)
得る	える(うる)	eru(uru)	to get;to gain;to win
円	えん	en	circle;money
延期	えんき	enki	postponement;adjournment
演技	えんぎ	engi	acting;performance
援助	えんじょ	enjo	assistance;aid;support
	エンジン	enjin	engine
演説	えんぜつ	enzetsu	speech;address
演奏	えんそう	ensou	musical performance
遠慮	えんりょ	enryo	diffidence;restraint;reserve
御	お	o	honourable
老い	おい	oi	old age;old person;the old;the aged
追い付く	おいつく	oitsuku	to overtake;to catch up (with)
王	おう	ou	king;ruler;sovereign;monarch
追う	おう	ou	to chase;to run after
王様	おうさま	ousama	king
王子	おうじ	ouji	prince
応じる	おうじる	oujiru	to respond;to satisfy;to accept;to comply with;to apply for
横断	おうだん	oudan	crossing
終える	おえる	oeru	to finish
大いに	おおいに	ooini	very;much;greatly
覆う	おおう	oou	to cover;to hide;to conceal;to wrap;to disguise
	オーバー	oobaa	(1) overcoat;(2) over
大家	おおや	ooya	rich family;distinguished family
丘	おか	oka	hill;height;knoll;rising ground
沖	おき	oki	open sea
奥	おく	oku	interior;inner part
贈る	おくる	okuru	to send;to give to;to award to;to confer on
起こる	おこる	okoru	to occur;to happen
幼い	おさない	osanai	very young;childish
収める	おさめる	osameru	to obtain;to reap;to pay;to supply;to accept
	おじいさん	ojiisan	grandfather;male senior-citizen
	おしゃべり	oshaberi	chattering;talk;idle talk
汚染	おせん	osen	pollution;contamination
	おそらく	osoraku	perhaps
恐れる	おそれる	osoreru	to fear;to be afraid of
恐ろしい	おそろしい	osoroshii	terrible;dreadful
お互い	おたがい	otagai	mutual;reciprocal;each other
穏やか	おだやか	odayaka	calm;gentle;quiet
劣る	おとる	otoru	to fall behind;to be inferior to
お腹	おなか	onaka	stomach
鬼	おに	oni	ogre;demon;it (i.e.; in a game of tag)
帯	おび	obi	band (e.g. conduction; valence)
お昼	おひる	ohiru	lunch;noon
	オフィス	ofisu	office
溺れる	おぼれる	oboreru	to be drowned;to indulge in
	おまえ	omae	(fam) you (sing);presence (of a high personage)
	おめでとう	omedetou	Congratulations!;an auspicious occasion!
お目に掛かる	おめにかかる	omenikakaru	(polite) to see;to meet
思い出	おもいで	omoide	memories;recollections;reminiscence
主に	おもに	omoni	mainly;primarily
思わず	おもわず	omowazu	unintentional;spontaneous
	おや	oya	parents
泳ぎ	およぎ	oyogi	swimming
	およそ	oyoso	about;roughly;as a rule;approximately
及ぼす	およぼす	oyobosu	to exert;to cause;to exercise
居る	おる	oru	to be (animate);to be;to exist
下す	おろす	orosu	to lower;to let go down
降ろす	おろす	orosu	to take down;to launch;to drop
終	おわり	owari	the end
音	おん	on	sound;note
恩	おん	on	favour;obligation;debt of gratitude
温暖	おんだん	ondan	warmth
温度	おんど	ondo	temperature
可	か	ka	passable
課	か	ka	counter for chapters (of a book)
	カー	kaa	car
	カード	kaado	card;curd
会	かい	kai	meeting;assembly;party;association;club
回	かい	kai	counter for occurrences
害	がい	gai	injury;harm;evil influence;damage
会員	かいいん	kaiin	member;the membership
絵画	かいが	kaiga	picture
海外	かいがい	kaigai	foreign;abroad;overseas
会計	かいけい	kaikei	account;finance;accountant
解決	かいけつ	kaiketsu	settlement;solution;resolution
会合	かいごう	kaigou	meeting;assembly
外交	がいこう	gaikou	diplomacy
開始	かいし	kaishi	start;commencement;beginning
解釈	かいしゃく	kaishaku	explanation;interpretation
外出	がいしゅつ	gaishutsu	outing;going out
改善	かいぜん	kaizen	betterment;improvement
快適	かいてき	kaiteki	pleasant;agreeable;comfortable
回復	かいふく	kaifuku	recovery (from illness);improvement;rehabilitation;restoration
飼う	かう	kau	to keep;to raise;to feed
替える	かえる	kaeru	to exchange;to interchange;to substitute;to replace
換える	かえる	kaeru	to exchange;to interchange;to substitute;to replace
香り	かおり	kaori	aroma;fragrance;scent;smell
画家	がか	gaka	painter;artist
抱える	かかえる	kakaeru	to hold or carry under or in the arms
価格	かかく	kakaku	price;value;cost
化学	かがく	kagaku	chemistry
輝く	かがやく	kagayaku	to shine;to glitter;to sparkle
係	かかり	kakari	official;duty;person in charge
掛かる	かかる	kakaru	to take (e.g. time; money; etc);to hang
罹る	かかる	kakaru	to suffer from
鍵	かぎ	kagi	key
限る	かぎる	kagiru	to restrict;to limit;to confine
描く	かく	kaku	to draw;to paint;to sketch;to depict;to describe
家具	かぐ	kagu	furniture
学	がく	gaku	learning;scholarship;erudition;knowledge
額	がく	gaku	forehead;brow
覚悟	かくご	kakugo	resolution;resignation;readiness;preparedness
確実	かくじつ	kakujitsu	certainty;reliability;soundness
学者	がくしゃ	gakusha	scholar
学習	がくしゅう	gakushuu	study;learning
隠す	かくす	kakusu	to hide;to conceal
拡大	かくだい	kakudai	magnification;enlargement
確認	かくにん	kakunin	affirmation;confirmation
学問	がくもん	gakumon	scholarship;study;learning
隠れる	かくれる	kakureru	to hide;to be hidden;to conceal oneself;to disappear
影	かげ	kage	shade;shadow;other side
陰	かげ	kage	shade;shadow;other side
欠ける	かける	kakeru	to be lacking
加減	かげん	kagen	addition and subtraction;allowance for
過去	かこ	kako	the past;bygone days;the previous
籠	かご	kago	basket;cage
囲む	かこむ	kakomu	to surround;to encircle
火災	かさい	kasai	conflagration;fire
貸し	かし	kashi	loan;lending
菓子	かし	kashi	pastry
家事	かじ	kaji	housework;domestic chores
賢い	かしこい	kashikoi	wise;clever;smart
歌手	かしゅ	kashu	singer
数	かず	kazu	number;figure
稼ぐ	かせぐ	kasegu	to earn income;to labor
数える	かぞえる	kazoeru	to count
型	かた	kata	mold;model;style;shape;data-type
肩	かた	kata	shoulder
硬い	かたい	katai	solid;hard (esp. metal; stone);unpolished writing
方々	かたがた	katagata	persons;this and that;here and there;everywhere
刀	かたな	katana	sword;saber;knife;engraving tool
語る	かたる	kataru	to talk;to tell;to recite
勝ち	かち	kachi	win;victory
価値	かち	kachi	value;worth;merit
	がっかり	gakkari	feel disappointed;be dejected;lose heart
活気	かっき	kakki	energy;liveliness
学期	がっき	gakki	term (school)
格好	かっこう	kakkou	shape;form;posture;suitability
活動	かつどう	katsudou	action;activity
活用	かつよう	katsuyou	conjugation;practical use
悲しむ	かなしむ	kanashimu	to be sad;to mourn for;to regret
必ずしも	かならずしも	kanarazushimo	(not) always;(not) necessarily;(not) all;(not) entirely
	かなり	kanari	considerably;fairly;quite
金	かね	kane	(1) gold;(2) gold general (shogi) (abbr)
金持ち	かねもち	kanemochi	rich man
可能	かのう	kanou	possible;practicable;feasible
株	かぶ	kabu	share;stock;stump (of tree)
被る	かぶる	kaburu	to suffer
構う	かまう	kamau	to mind;to care about;to be concerned about
我慢	がまん	gaman	patience;endurance;perseverance
上	かみ	kami	(1) first volume;(2) superior quality;(3) governmental
神	かみ	kami	god
雷	かみなり	kaminari	thunder
髪の毛	かみのけ	kaminoke	hair (head)
科目	かもく	kamoku	(school) subject;curriculum;course
	かもしれない	kamoshirenai	may;might;perhaps;may be;possibly
火曜	かよう	kayou	(abbr) Tuesday
空	から	kara	sky
柄	がら	gara	hilt (of a sword);haft (of a dagger);handgrip
刈る	かる	karu	to cut (hair);to mow (grass);to harvest
彼等	かれら	karera	they (usually male)
皮	かわ	kawa	skin;hide;leather;fur;pelt;bark;shell
革	かわ	kawa	leather
	かわいそう	kawaisou	poor;pitiable;pathetic
	かわいらしい	kawairashii	lovely;sweet
缶	かん	kan	can;tin
勘	かん	kan	perception;intuition;the sixth sense
考え	かんがえ	kangae	thinking;thought;ideas;intention
感覚	かんかく	kankaku	sense;sensation
観客	かんきゃく	kankyaku	audience;spectator(s)
環境	かんきょう	kankyou	environment;circumstance
歓迎	かんげい	kangei	welcome;reception
観光	かんこう	kankou	sightseeing
観察	かんさつ	kansatsu	observation;survey
感じ	かんじ	kanji	feeling;sense;impression
感謝	かんしゃ	kansha	thanks;gratitude
患者	かんじゃ	kanja	a patient
勘定	かんじょう	kanjou	calculation;counting;consideration
感情	かんじょう	kanjou	emotion(s);feeling(s);sentiment
感じる	かんじる	kanjiru	to feel;to sense;to experience
感心	かんしん	kanshin	admiration;Well done!
関心	かんしん	kanshin	concern;interest
関する	かんする	kansuru	to concern;to be related
完成	かんせい	kansei	(1) complete;completion;(2) perfection;accomplishment
完全	かんぜん	kanzen	perfection;completeness
感動	かんどう	kandou	being deeply moved;excitement;impression;deep emotion
監督	かんとく	kantoku	supervision;control;superintendence
管理	かんり	kanri	control;management (e.g. of a business)
完了	かんりょう	kanryou	completion;conclusion
関連	かんれん	kanren	relation;connection;relevance
議員	ぎいん	giin	member of the Diet; congress or parliament
記憶	きおく	kioku	memory;recollection;remembrance
気温	きおん	kion	temperature
機械	きかい	kikai	machine;mechanism
議会	ぎかい	gikai	Diet;congress;parliament
期間	きかん	kikan	period;term
機関	きかん	kikan	organ;mechanism;facility;engine
企業	きぎょう	kigyou	enterprise;undertaking
効く	きく	kiku	to be effective
機嫌	きげん	kigen	humour;temper;mood
気候	きこう	kikou	climate
岸	きし	kishi	bank;coast;shore
生地	きじ	kiji	birthplace
記事	きじ	kiji	article;news story;report;account
技師	ぎし	gishi	engineer;technician
記者	きしゃ	kisha	reporter
傷	きず	kizu	wound;injury;hurt;cut
期待	きたい	kitai	expectation;anticipation;hope
帰宅	きたく	kitaku	returning home
貴重	きちょう	kichou	precious;valuable
議長	ぎちょう	gichou	chairman
	きちんと	kichinto	precisely;accurately
	きつい	kitsui	tight;close;intense
気付く	きづく	kizuku	to notice;to recognize;to become aware of
気に入る	きにいる	kiniiru	to be pleased with;to suit
記入	きにゅう	kinyuu	entry;filling in of forms
記念	きねん	kinen	commemoration;memory
機能	きのう	kinou	function;faculty
気の毒	きのどく	kinodoku	pitiful;a pity
寄付	きふ	kifu	contribution;donation
希望	きぼう	kibou	hope;wish;aspiration
基本	きほん	kihon	foundation;basis;standard
決まり	きまり	kimari	settlement;conclusion;regulation;rule
気味	きみ	kimi	-like;-looking;-looked
奇妙	きみょう	kimyou	strange;queer;curious
義務	ぎむ	gimu	duty;obligation;responsibility
疑問	ぎもん	gimon	question;problem;doubt;guess
逆	ぎゃく	gyaku	reverse;opposite
	キャプテン	kyaputen	captain
	キャンプ	kyanpu	camp
九	きゅう	kyuu	nine
旧	きゅう	kyuu	ex-
級	きゅう	kyuu	class; grade; rank;school class; grade
球	きゅう	kyuu	globe;sphere;ball
休暇	きゅうか	kyuuka	holiday;day off;furlough
休憩	きゅうけい	kyuukei	rest;break;recess;intermission
急激	きゅうげき	kyuugeki	sudden;precipitous;radical
吸収	きゅうしゅう	kyuushuu	absorption;suction;attraction
救助	きゅうじょ	kyuujo	relief;aid;rescue
急速	きゅうそく	kyuusoku	rapid (e.g. progress)
急に	きゅうに	kyuuni	suddenly
給料	きゅうりょう	kyuuryou	salary;wages
器用	きよう	kiyou	skillful;handy
教科書	きょうかしょ	kyoukasho	text book
競技	きょうぎ	kyougi	game;match;contest
行儀	ぎょうぎ	gyougi	manners
供給	きょうきゅう	kyoukyuu	supply;provision
教師	きょうし	kyoushi	teacher (classroom)
教授	きょうじゅ	kyouju	teaching;instruction;professor
強調	きょうちょう	kyouchou	emphasis;stress;stressed point
共通	きょうつう	kyoutsuu	commonness;community
共同	きょうどう	kyoudou	cooperation;association;collaboration;joint
恐怖	きょうふ	kyoufu	be afraid;dread;dismay;terror
協力	きょうりょく	kyouryoku	cooperation;collaboration
強力	きょうりょく	kyouryoku	herculean strength;mountain carrier-guide
許可	きょか	kyoka	permission;approval
局	きょく	kyoku	court lady;lady in waiting
巨大	きょだい	kyodai	huge;gigantic;enormous
嫌う	きらう	kirau	to hate;to dislike;to loathe
霧	きり	kiri	fog;mist
切れ	きれ	kire	cloth;piece;cut;chop
切れる	きれる	kireru	(1) to cut well;to be sharp;(2) to break (off)
	キロ	kiro	(abbr) kilo-;kilogram;kilometre;10^3
記録	きろく	kiroku	record;minutes;document
議論	ぎろん	giron	argument;discussion;dispute
金	きん	kin	(1) gold;(2) gold general (shogi) (abbr)
銀	ぎん	gin	(1) silver;silver coin;silver paint
禁煙	きんえん	kinen	No Smoking!
金額	きんがく	kingaku	amount of money
金庫	きんこ	kinko	safe;vault;treasury;provider of funds
禁止	きんし	kinshi	prohibition;ban
金銭	きんせん	kinsen	money;cash
金属	きんぞく	kinzoku	metal
近代	きんだい	kindai	present day
緊張	きんちょう	kinchou	tension;mental strain;nervousness
筋肉	きんにく	kinniku	muscle;sinew
金融	きんゆう	kinyuu	monetary circulation;credit situation
金曜	きんよう	kinyou	(abbr) Friday
九	く	ku	nine
句	く	ku	sentence
食う	くう	kuu	(male) (vulg) to eat
偶然	ぐうぜん	guuzen	(by) chance;unexpectedly;suddenly
臭い	くさい	kusai	odour;scent;smell;stench
鎖	くさり	kusari	chain
腐る	くさる	kusaru	to rot;to go bad
癖	くせ	kuse	a habit (often a bad habit);peculiarity
管	くだ	kuda	pipe;tube
具体	ぐたい	gutai	concrete;tangible;material
下さる	くださる	kudasaru	(hon) to give;to confer
下り	くだり	kudari	down-train (going away from Tokyo)
苦痛	くつう	kutsuu	pain;agony
	ぐっすり	gussuri	sound asleep;fast asleep
区別	くべつ	kubetsu	distinction;differentiation;classification
組	くみ	kumi	class;group;team;set
組合	くみあい	kumiai	association;union
組む	くむ	kumu	to put together
曇	くもり	kumori	cloudiness;cloudy weather;shadow
位	くらい	kurai	grade;rank;about
暮らし	くらし	kurashi	living;livelihood;subsistence;circumstances
	クラシック	kurashikku	classic(s)
暮らす	くらす	kurasu	to live;to get along
	グラス	gurasu	(1) glass;(2) grass
	グランド	gurando	gland;grand;(electrical) ground
	クリーム	kuriimu	cream
繰り返す	くりかえす	kurikaesu	to repeat;to do something over again
	クリスマス	kurisumasu	Christmas
狂う	くるう	kuruu	to go mad;to get out of order
	グループ	guruupu	group
苦しい	くるしい	kurushii	painful;difficult
苦しむ	くるしむ	kurushimu	to suffer;to groan;to be worried
暮れ	くれ	kure	year end;sunset;nightfall;end
苦労	くろう	kurou	troubles;hardships
加える	くわえる	kuwaeru	to append;to sum up;to add (up)
詳しい	くわしい	kuwashii	knowing very well;detailed;full;accurate
加わる	くわわる	kuwawaru	to join in;to accede to;to increase;to gain in (influence)
訓	くん	kun	native Japanese reading of a Chinese character
軍	ぐん	gun	army;force;troops
軍隊	ぐんたい	guntai	army;troops
訓練	くんれん	kunren	practice;training
下	げ	ge	under;below;beneath
計	けい	kei	plan
敬意	けいい	keii	respect;honour
経営	けいえい	keiei	management;administration
計画	けいかく	keikaku	plan;project;schedule;scheme;program
景気	けいき	keiki	condition;state;business (condition)
経験	けいけん	keiken	experience
傾向	けいこう	keikou	tendency;trend;inclination
警告	けいこく	keikoku	warning;advice
計算	けいさん	keisan	calculation;reckoning
掲示	けいじ	keiji	notice;bulletin
刑事	けいじ	keiji	criminal case;(police) detective
芸術	げいじゅつ	geijutsu	(fine) art;the arts
契約	けいやく	keiyaku	contract;compact;agreement
経由	けいゆ	keiyu	go by the way;via
	ケース	keesu	case
	ゲーム	geemu	game
怪我	けが	kega	injury (to animate object);hurt
劇	げき	geki	drama;play
劇場	げきじょう	gekijou	theatre;playhouse
化粧	けしょう	keshou	make-up (cosmetic)
	けち	kechi	stinginess;miser;miserliness
結果	けっか	kekka	result;consequence
欠陥	けっかん	kekkan	defect;fault;deficiency
結局	けっきょく	kekkyoku	after all;eventually
決心	けっしん	kesshin	determination;resolution
欠席	けっせき	kesseki	absence;non-attendance
決定	けってい	kettei	decision;determination
欠点	けってん	ketten	faults;defect;weakness
月曜	げつよう	getsuyou	Monday
結論	けつろん	ketsuron	conclusion
煙	けむり	kemuri	smoke;fumes
券	けん	ken	ticket;coupon;bond;certificate
県	けん	ken	prefecture
軒	けん	ken	eaves
喧嘩	けんか	kenka	quarrel;(drunken) brawl;failure
見解	けんかい	kenkai	opinion;point of view
限界	げんかい	genkai	limit;bound
現金	げんきん	genkin	cash;ready money;mercenary;self-interested
言語	げんご	gengo	language
健康	けんこう	kenkou	health;sound;wholesome
検査	けんさ	kensa	inspection (e.g. customs; factory);examination
現在	げんざい	genzai	present;up to now;nowadays;modern times;current
現実	げんじつ	genjitsu	reality
現象	げんしょう	genshou	phenomenon
現状	げんじょう	genjou	present condition;existing state;status quo
建設	けんせつ	kensetsu	construction;establishment
現代	げんだい	gendai	nowadays;modern times;present-day
建築	けんちく	kenchiku	construction;architecture
見当	けんとう	kentou	be found;aim;estimate;guess;approx
検討	けんとう	kentou	consideration;examination;investigation;study;scrutiny
現場	げんば	genba	actual spot;scene;scene of the crime
憲法	けんぽう	kenpou	constitution
権利	けんり	kenri	right;privilege
後	ご	go	afterwards;since then;in the future
語	ご	go	language;word
恋	こい	koi	love;tender passion
濃い	こい	koi	thick (as of color; liquid);dense;strong
恋人	こいびと	koibito	lover;sweetheart
幸運	こううん	kouun	good luck;fortune
講演	こうえん	kouen	lecture;address
効果	こうか	kouka	effect;effectiveness;efficacy;result
硬貨	こうか	kouka	coin
高価	こうか	kouka	high price
豪華	ごうか	gouka	wonderful;gorgeous;splendor;pomp;extravagance
合格	ごうかく	goukaku	success;passing (e.g. exam);eligibility
交換	こうかん	koukan	exchange;interchange;reciprocity
航空	こうくう	koukuu	aviation;flying
光景	こうけい	koukei	scene;spectacle
合計	ごうけい	goukei	sum total;total amount
攻撃	こうげき	kougeki	attack;strike;offensive;criticism;censure
貢献	こうけん	kouken	contribution;services
広告	こうこく	koukoku	advertisement
交際	こうさい	kousai	company;friendship;association;society;acquaintance
後者	こうしゃ	kousha	the latter
工場	こうば	kouba	factory;plant;mill;workshop
構成	こうせい	kousei	organization;composition
高速	こうそく	kousoku	high speed;high gear
行動	こうどう	koudou	action;conduct;behaviour;mobilization
強盗	ごうとう	goutou	robbery;burglary
幸福	こうふく	koufuku	happiness;blessedness
公平	こうへい	kouhei	fairness;impartial;justice
候補	こうほ	kouho	candidacy
考慮	こうりょ	kouryo	consideration;taking into account
越える	こえる	koeru	to exceed;to cross over;to cross
	コーチ	koochi	coach
	コード	koodo	code;cord;chord
氷	こおり	koori	ice;hail
凍る	こおる	kooru	to freeze;to be frozen over;to congeal
	ゴール	gooru	goal
誤解	ごかい	gokai	misunderstanding
語学	ごがく	gogaku	language study
呼吸	こきゅう	kokyuu	breath;respiration
故郷	こきょう	kokyou	home town;birthplace;old village;historic village
極	ごく	goku	quite;very
国語	こくご	kokugo	national language
黒板	こくばん	kokuban	blackboard
克服	こくふく	kokufuku	subjugation;conquest
国民	こくみん	kokumin	national;people;citizen
穀物	こくもつ	kokumotsu	grain;cereal;corn
ここ	ここ	koko	here
腰	こし	koshi	hip
故障	こしょう	koshou	break-down;failure;accident;out of order
個人	こじん	kojin	individual;private person;personal;private
越す	こす	kosu	to go over (e.g. with audience)
国家	こっか	kokka	state;country;nation
国会	こっかい	kokkai	National Diet;parliament;congress
国境	こっきょう	kokkyou	national or state border
骨折	こっせつ	kossetsu	bone fracture
小包	こづつみ	kozutsumi	parcel;package
事	こと	koto	thing;matter;fact;circumstances
異なる	ことなる	kotonaru	to differ;to vary;to disagree
諺	ことわざ	kotowaza	proverb;maxim
断る	ことわる	kotowaru	to refuse;to decline;to dismiss
粉	こな	kona	flour;meal;powder
この	この	kono	this
好み	このみ	konomi	liking;taste;choice
好む	このむ	konomu	to like;to prefer
	コピー	kopii	(1) a (photo)copy;(2) blurb on a book jacket
塵	ごみ	gomi	dust;dirt
小麦	こむぎ	komugi	wheat
	ごめんなさい	gomennasai	I beg your pardon;excuse me
小屋	こや	koya	hut;cabin;shed;(animal) pen
	これら	korera	these
頃	ころ	koro	time;about;toward;approximately (time)
殺す	ころす	korosu	to kill
転ぶ	ころぶ	korobu	to fall down;to fall over
今回	こんかい	konkai	now;this time;lately
今後	こんご	kongo	from now on;hereafter
混雑	こんざつ	konzatsu	confusion;congestion
	こんなに	konnani	so;like this;in this way
困難	こんなん	konnan	difficulty;distress
今日	こんにち	konnichi	today;this day
	コンピューター	konpyuutaa	computer
婚約	こんやく	konyaku	engagement;betrothal
混乱	こんらん	konran	disorder;chaos;confusion;mayhem
差	さ	sa	difference;variation
	サービス	saabisu	(1) service;support system;(2) goods or services without charge
際	さい	sai	on the occasion of;circumstances
最高	さいこう	saikou	highest;supreme;the most
財産	ざいさん	zaisan	property;fortune;assets
最終	さいしゅう	saishuu	last;final;closing
最中	さいちゅう	saichuu	in the middle of
最低	さいてい	saitei	least;lowest;worst
才能	さいのう	sainou	talent;ability
裁判	さいばん	saiban	trial;judgement
材料	ざいりょう	zairyou	ingredients;material
幸い	さいわい	saiwai	happiness;blessedness
	サイン	sain	(1) autograph;(2) sign;(3) sine
境	さかい	sakai	border;boundary;mental state
逆らう	さからう	sakarau	to go against;to oppose;to disobey;to defy
盛り	さかり	sakari	helping;serving
作業	さぎょう	sagyou	work;operation;manufacturing;fatigue duty
昨	さく	saku	last (year);yesterday
作品	さくひん	sakuhin	work;opus;performance;production
作物	さくもつ	sakumotsu	produce (e.g. agricultural);crops
桜	さくら	sakura	cherry blossom;cherry tree
酒	さけ	sake	alcohol;sake
叫ぶ	さけぶ	sakebu	to shout;to cry
避ける	さける	sakeru	(1) to avoid (physical contact );(2) to ward off;to avert
支える	ささえる	sasaeru	to be blocked;to choke;to be obstructed
指す	さす	sasu	to point;to put up umbrella;to play
座席	ざせき	zaseki	seat
誘う	さそう	sasou	(1) to invite;to ask;(2) to tempt;to lure;to induce
札	さつ	satsu	(1) token;label;(2) ticket;(3) charm
作家	さっか	sakka	author;writer;novelist;artist
作曲	さっきょく	sakkyoku	composition;setting (of music)
	ざっと	zatto	roughly;in round numbers
	さっぱり	sappari	feeling refreshed;feeling relieved;neat;trimmed
	さて	sate	well;now;then
砂漠	さばく	sabaku	desert
差別	さべつ	sabetsu	discrimination;distinction;differentiation
作法	さほう	sahou	manners;etiquette;propriety
様々	さまざま	samazama	varied;various
覚ます	さます	samasu	to awaken
覚める	さめる	sameru	to wake;to wake up
左右	さゆう	sayuu	(1) left and right;(2) influence;control;domination
皿	さら	sara	plate;dish
更に	さらに	sarani	furthermore;again;after all;more and more;moreover
去る	さる	saru	to leave;to go away
猿	さる	saru	monkey
騒ぎ	さわぎ	sawagi	uproar;disturbance
参加	さんか	sanka	participation
参考	さんこう	sankou	reference;consultation
賛成	さんせい	sansei	approval;agreement;support;favour
酸素	さんそ	sanso	oxygen
散歩	さんぽ	sanpo	walk;stroll
氏	し	shi	family name;lineage;birth
詩	し	shi	poem;verse of poetry
幸せ	しあわせ	shiawase	happiness;good fortune;luck;blessing
	ジーンズ	jiinzu	jeans
ジェット機	ジェットき	jettoki	jet aeroplane
直に	じかに	jikani	immediately;readily;directly
	しかも	shikamo	moreover;furthermore;nevertheless;and yet
叱る	しかる	shikaru	to scold
式	しき	shiki	equation;formula;ceremony
直	じき	jiki	earnestly;immediately;exactly
時期	じき	jiki	time;season;period
支給	しきゅう	shikyuu	payment;allowance
	しきりに	shikirini	frequently;repeatedly;incessantly;eagerly
刺激	しげき	shigeki	stimulus;impetus;incentive
資源	しげん	shigen	resources
事件	じけん	jiken	event;affair;incident
時刻	じこく	jikoku	instant;time;moment
自殺	じさつ	jisatsu	suicide
事実	じじつ	jijitsu	fact;truth;reality
支出	ししゅつ	shishutsu	expenditure;expenses
事情	じじょう	jijou	circumstances;consideration;conditions;situation;reasons
詩人	しじん	shijin	poet
自身	じしん	jishin	by oneself;personally
沈む	しずむ	shizumu	to sink;to feel depressed
自然	しぜん	shizen	nature;spontaneous
思想	しそう	shisou	thought;idea
舌	した	shita	tongue
次第	しだい	shidai	(1) order;precedence;(2) circumstances;(3) immediate(ly)
事態	じたい	jitai	situation;present state of affairs
従う	したがう	shitagau	to abide (by the rules);to obey;to follow;to accompany
したがって	したがって	shitagatte	therefore;consequently;in accordance with
支度	したく	shitaku	preparation
親しい	したしい	shitashii	intimate;close (e.g. friend)
質	しつ	shitsu	quality;nature (of person)
失業	しつぎょう	shitsugyou	unemployment
実験	じっけん	jikken	experiment
実現	じつげん	jitsugen	implementation;materialization;realization
実行	じっこう	jikkou	practice;performance;execution (e.g. program);realization
実際	じっさい	jissai	practical;actual condition;status quo
実施	じっし	jisshi	enforcement;enact;put into practice;carry out;operation
	じっと	jitto	fixedly;firmly;patiently;quietly
実に	じつに	jitsuni	indeed;truly;surely
実は	じつは	jitsuha	as a matter of fact;by the way
失望	しつぼう	shitsubou	disappointment;despair
支店	してん	shiten	branch store (office)
指導	しどう	shidou	leadership;guidance;coaching
自動	じどう	jidou	automatic;self-motion
品	しな	shina	thing;article;goods;dignity;article (goods);counter for meal courses
支配	しはい	shihai	rule;control;direction
芝居	しばい	shibai	play;drama
	しばしば	shibashiba	often;again and again;frequently
芝生	しばふ	shibafu	lawn
支払	しはらい	shiharai	payment
支払う	しはらう	shiharau	to pay
死亡	しぼう	shibou	death;mortality
資本	しほん	shihon	funds;capital
姉妹	しまい	shimai	sisters
	しまう	shimau	to finish;to close;to do something completely
	しまった	shimatta	Damn it!
自慢	じまん	jiman	pride;boast
事務	じむ	jimu	business;office work
示す	しめす	shimesu	to denote;to show;to point out;to indicate
占める	しめる	shimeru	(1) to comprise;to account for;to make up (of);(2) to hold;to occupy
下	しも	shimo	under;below;beneath
霜	しも	shimo	frost
	じゃあ	jaa	well;well then
借金	しゃっきん	shakkin	debt;loan;liabilities
	しゃべる	shaberu	to talk;to chat;to chatter
邪魔	じゃま	jama	hindrance;intrusion
週	しゅう	shuu	week
州	しゅう	shuu	sandbank
十	じゅう	juu	10;ten
銃	じゅう	juu	gun
周囲	しゅうい	shuui	surroundings;circumference;environs
収穫	しゅうかく	shuukaku	harvest;crop;ingathering
週間	しゅうかん	shuukan	week;weekly
宗教	しゅうきょう	shuukyou	religion
重視	じゅうし	juushi	importance;stress;serious consideration
就職	しゅうしょく	shuushoku	finding employment;inauguration
	ジュース	juusu	juice;soft drink;deuce
修正	しゅうせい	shuusei	amendment;correction;revision;modification
渋滞	じゅうたい	juutai	congestion (e.g. traffic);delay;stagnation
重大	じゅうだい	juudai	serious;important;grave;weighty
住宅	じゅうたく	juutaku	resident;housing
集団	しゅうだん	shuudan	group;mass
集中	しゅうちゅう	shuuchuu	concentration;focusing the mind
収入	しゅうにゅう	shuunyuu	income;receipts;revenue
住民	じゅうみん	juumin	citizens;inhabitants;residents;population
重要	じゅうよう	juuyou	important;momentous;essential;principal;major
修理	しゅうり	shuuri	repairing;mending
主義	しゅぎ	shugi	doctrine;rule;principle
宿泊	しゅくはく	shukuhaku	lodging
手術	しゅじゅつ	shujutsu	surgical operation
首相	しゅしょう	shushou	Prime Minister
手段	しゅだん	shudan	means;way;measure
主張	しゅちょう	shuchou	claim;request;insistence;assertion
出身	しゅっしん	shusshin	graduate from;come from
出席	しゅっせき	shusseki	attendance;presence
出発	しゅっぱつ	shuppatsu	departure
出版	しゅっぱん	shuppan	publication
首都	しゅと	shuto	capital city
主婦	しゅふ	shufu	housewife;mistress
主要	しゅよう	shuyou	chief;main;principal;major
需要	じゅよう	juyou	demand;request
種類	しゅるい	shurui	variety;kind;type
順	じゅん	jun	order;turn
瞬間	しゅんかん	shunkan	moment;second;instant
順調	じゅんちょう	junchou	favourable;doing well;O.K.;all right
順番	じゅんばん	junban	turn (in line);order of things
準備	じゅんび	junbi	preparation;arrangements;provision;reserve
使用	しよう	shiyou	use;application;employment;utilization
小	しょう	shou	small
章	しょう	shou	(1) chapter;section;(2) medal
賞	しょう	shou	prize;award
障害	しょうがい	shougai	obstacle;impediment (fault);damage
奨学金	しょうがくきん	shougakukin	scholarship
乗客	じょうきゃく	joukyaku	passenger
上京	じょうきょう	joukyou	proceeding to the capital (Tokyo)
状況	じょうきょう	joukyou	state of affairs;situation;circumstances
条件	じょうけん	jouken	conditions;terms
正午	しょうご	shougo	noon;mid-day
正直	しょうじき	shoujiki	honesty;integrity;frankness
常識	じょうしき	joushiki	common sense
少女	しょうじょ	shoujo	daughter;young lady;virgin;maiden;little girl
少々	しょうしょう	shoushou	just a minute;small quantity
症状	しょうじょう	shoujou	symptoms;condition
生じる	しょうじる	shoujiru	to produce;to yield;to result from;to arise;to be generated
招待	しょうたい	shoutai	invitation
状態	じょうたい	joutai	condition;situation;circumstances;state
上達	じょうたつ	joutatsu	improvement;advance;progress
冗談	じょうだん	joudan	jest;joke
承知	しょうち	shouchi	consent;acceptance;assent;admitting
上等	じょうとう	joutou	superiority;first class;very good
衝突	しょうとつ	shoutotsu	collision;conflict
商人	しょうにん	shounin	trader;shopkeeper;merchant
承認	しょうにん	shounin	recognition;acknowledgement;approval;consent;agreement
少年	しょうねん	shounen	boys;juveniles
商売	しょうばい	shoubai	trade;business;commerce;transaction;occupation
消費	しょうひ	shouhi	consumption;expenditure
商品	しょうひん	shouhin	commodity;article of commerce;goods;stock;merchandise
消防	しょうぼう	shoubou	fire fighting;fire department
情報	じょうほう	jouhou	information;(military) intelligence
証明	しょうめい	shoumei	proof;verification
女王	じょおう	joou	queen
職	しょく	shoku	employment
職業	しょくぎょう	shokugyou	occupation;business
食事	しょくじ	shokuji	meal
食卓	しょくたく	shokutaku	dining table
食品	しょくひん	shokuhin	commodity;foodstuff
植物	しょくぶつ	shokubutsu	plant;vegetation
食物	しょくもつ	shokumotsu	food;foodstuff
食欲	しょくよく	shokuyoku	appetite (for food)
食料	しょくりょう	shokuryou	food
食糧	しょくりょう	shokuryou	provisions;rations
書斎	しょさい	shosai	study
女子	じょし	joshi	woman;girl
助手	じょしゅ	joshu	helper;helpmeet;assistant;tutor
徐々に	じょじょに	jojoni	slowly;little by little;gradually;steadily;quietly
署名	しょめい	shomei	signature
書物	しょもつ	shomotsu	books
女優	じょゆう	joyuu	actress
処理	しょり	shori	processing;dealing with;treatment;disposition;disposal
書類	しょるい	shorui	documents;official papers
知らせ	しらせ	shirase	notice
尻	しり	shiri	buttocks;bottom
印	しるし	shirushi	(1) mark;(2) symbol;(3) evidence
城	しろ	shiro	castle
進学	しんがく	shingaku	going on to university
神経	しんけい	shinkei	nerve;sensitivity
真剣	しんけん	shinken	seriousness;earnestness
信仰	しんこう	shinkou	(religious) faith;belief;creed
信号	しんごう	shingou	traffic lights;signal;semaphore
人工	じんこう	jinkou	artificial;manmade;human work;human skill;artificiality
深刻	しんこく	shinkoku	serious
診察	しんさつ	shinsatsu	medical examination
人種	じんしゅ	jinshu	race (of people)
信じる	しんじる	shinjiru	to believe;to place trust in
人生	じんせい	jinsei	(human) life (i.e. conception to death)
親戚	しんせき	shinseki	relative
新鮮	しんせん	shinsen	fresh
心臓	しんぞう	shinzou	heart
身体	しんたい	shintai	the body
身長	しんちょう	shinchou	height (of body);stature
慎重	しんちょう	shinchou	discretion;prudence
心配	しんぱい	shinpai	worry;concern;anxiety;care
審判	しんぱん	shinpan	refereeing;trial;judgement;umpire;referee
人物	じんぶつ	jinbutsu	character;personality;person;man;personage;talented man
進歩	しんぽ	shinpo	progress;development
親友	しんゆう	shinyuu	close friend;buddy
信用	しんよう	shinyou	confidence;dependence;credit;faith
信頼	しんらい	shinrai	reliance;trust;confidence
心理	しんり	shinri	mentality
人類	じんるい	jinrui	mankind;humanity
巣	す	su	nest;rookery;breeding place;beehive;cobweb
図	ず	zu	figure (e.g. Fig 1);drawing;picture;illustration
水準	すいじゅん	suijun	(1) water level;(2) level;standard
推薦	すいせん	suisen	recommendation
	スイッチ	suicchi	switch
随分	ずいぶん	zuibun	extremely
睡眠	すいみん	suimin	sleep
数	すう	suu	number;figure
数字	すうじ	suuji	numeral;figure
	スープ	suupu	(Western) soup
末	すえ	sue	the end of;powder
姿	すがた	sugata	figure;shape;appearance
	スキー	sukii	skiing
空く	すく	suku	(1) to open;to become empty;(2) to be less crowded
救う	すくう	sukuu	to rescue from;to help out of
優れる	すぐれる	sugureru	to surpass;to outstrip;to excel
	スケート	sukeeto	skate(s);skating
	すごい	sugoi	terrible;dreadful;terrific;amazing;great
少しも	すこしも	sukoshimo	anything of;not one bit
過ごす	すごす	sugosu	to pass;to spend;to go through;to tide over
筋	すじ	suji	muscle;string;line
進める	すすめる	susumeru	to advance;to promote;to hasten
勧める	すすめる	susumeru	to recommend;to advise;to encourage;to offer (wine)
	スター	sutaa	star
	スタイル	sutairu	style
	スタンド	sutando	stand
頭痛	ずつう	zutsuu	headache
	ずっと	zutto	consecutively;throughout;a lot
	すてき	suteki	lovely;dreamy;beautiful;great
既に	すでに	sudeni	already;too late
	すなわち	sunawachi	that is;namely;i.e.
素晴らしい	すばらしい	subarashii	wonderful;splendid;magnificent
	スピーチ	supiichi	speech
全て	すべて	subete	all;the whole;entirely;in general;wholly
済ませる	すませる	sumaseru	to be finished
角	すみ	sumi	horn
為る	する	suru	to change;to be of use;to reach to
すると	すると	suruto	thereupon;hereupon
鋭い	するどい	surudoi	pointed;sharp
背	せい	sei	height;stature
正	せい	sei	(logical) true;regular
生	せい	sei	(1) draft (beer);(2) raw;unprocessed
性	せい	sei	sex;gender
所為	せい	sei	cause;reason;fault
税	ぜい	zei	tax
性格	せいかく	seikaku	character;personality
正確	せいかく	seikaku	accurate;punctuality;exactness;authenticity;veracity
世紀	せいき	seiki	century;era
請求	せいきゅう	seikyuu	claim;demand;application;request
税金	ぜいきん	zeikin	tax;duty
清潔	せいけつ	seiketsu	clean
制限	せいげん	seigen	restriction;restraint;limitation
成功	せいこう	seikou	success;hit
生産	せいさん	seisan	production;manufacture
正式	せいしき	seishiki	due form;official;formality
精神	せいしん	seishin	mind;soul;heart;spirit;intention
成人	せいじん	seijin	adult
精々	せいぜい	seizei	at the most;at best;to the utmost;as much (far) as possible
成績	せいせき	seiseki	results;record
製造	せいぞう	seizou	manufacture;production
贅沢	ぜいたく	zeitaku	luxury;extravagance
成長	せいちょう	seichou	growth;grow to adulthood
制度	せいど	seido	system;institution;organization
青年	せいねん	seinen	youth;young man
製品	せいひん	seihin	manufactured goods;finished goods
政府	せいふ	seifu	government;administration
生物	せいぶつ	seibutsu	raw food
生命	せいめい	seimei	life;existence
整理	せいり	seiri	sorting;arrangement;adjustment;regulation
咳	せき	seki	cough
石炭	せきたん	sekitan	coal
責任	せきにん	sekinin	duty;responsibility
石油	せきゆ	sekiyu	oil;petroleum;kerosene
世間	せけん	seken	world;society
説	せつ	setsu	theory
積極的	せっきょくてき	sekkyokuteki	positive;active;proactive
設計	せっけい	sekkei	plan;design
絶対	ぜったい	zettai	absolute;unconditional;absoluteness
	セット	setto	set
設備	せつび	setsubi	equipment;device;facilities;installation
絶滅	ぜつめつ	zetsumetsu	destruction;extinction
節約	せつやく	setsuyaku	economising;saving
是非	ぜひ	zehi	certainly;without fail
責める	せめる	semeru	to condemn;to blame;to criticize
世話	せわ	sewa	looking after;help;aid;assistance
善	ぜん	zen	good;goodness;right;virtue
全	ぜん	zen	all;whole;entire;complete;overall;pan
全員	ぜんいん	zenin	all members (unanimity);all hands;the whole crew
専攻	せんこう	senkou	major subject;special study
全国	ぜんこく	zenkoku	country-wide;nation-wide;whole country;national
先日	せんじつ	senjitsu	the other day;a few days ago
前者	ぜんしゃ	zensha	the former
選手	せんしゅ	senshu	(1) player (in game);(2) team
前進	ぜんしん	zenshin	advance;drive;progress
全然	ぜんぜん	zenzen	(1) wholly;entirely;completely;(2) not at all (with neg. verb)
	センター	sentaa	a center
全体	ぜんたい	zentai	whole;entirety;whatever (is the matter)
選択	せんたく	sentaku	selection;choice
そう	そう	sou	so
象	ぞう	zou	elephant
騒音	そうおん	souon	noise
増加	ぞうか	zouka	increase;addition
操作	そうさ	sousa	operation;management;processing
掃除	そうじ	souji	cleaning;sweeping
想像	そうぞう	souzou	imagination;guess
相続	そうぞく	souzoku	succession;inheritance
相談	そうだん	soudan	consultation;discussion
装置	そうち	souchi	equipment;installation;apparatus
相当	そうとう	soutou	suitable;fair;tolerable;proper
速度	そくど	sokudo	speed;velocity;rate
底	そこ	soko	bottom;sole
	そこで	sokode	so (conj);accordingly;now;then;thereupon
組織	そしき	soshiki	(1) organization;(2) structure;construction;(3) tissue;(4) system
	そして	soshite	and
注ぐ	そそぐ	sosogu	to pour (into);to irrigate;to pay;to fill;to feed (e.g. a fire)
育つ	そだつ	sodatsu	to raise (child);to be brought up;to grow (up)
	そっくり	sokkuri	all;altogether;entirely;be just like;the splitting image of
	そっと	sotto	face of the earth
袖	そで	sode	sleeve
備える	そなえる	sonaeru	to furnish;to provide for;to equip;to install
	そのうち	sonouchi	eventually;sooner or later;of the previously mentioned
	そのまま	sonomama	without change;as it is (i.e. now)
側	そば	soba	side;edge;third person
	ソファー	sofaa	sofa;couch
粗末	そまつ	somatsu	crude;rough;plain;humble
	それぞれ	sorezore	each;every;either;respectively;severally
	それでも	soredemo	but (still);and yet;nevertheless;even so;notwithstanding
	それと	soreto	To that
	それとも	soretomo	or;or else
損	そん	son	loss;disadvantage
損害	そんがい	songai	damage;injury;loss
尊敬	そんけい	sonkei	respect;esteem;reverence;honour
存在	そんざい	sonzai	existence;being
尊重	そんちょう	sonchou	respect;esteem;regard
田	た	ta	rice field
他	た	ta	other (esp. places and things)
対	たい	tai	pair;couple;set
台	だい	dai	stand;rack;table;support
題	だい	dai	title;subject;theme;topic
体育	たいいく	taiiku	physical education;gymnastics;athletics
体温	たいおん	taion	temperature (body)
大会	たいかい	taikai	convention;tournament;mass meeting;rally
大気	たいき	taiki	atmosphere
代金	だいきん	daikin	price;payment;cost;charge
退屈	たいくつ	taikutsu	tedium;boredom
滞在	たいざい	taizai	stay;sojourn
大使	たいし	taishi	ambassador
大した	たいした	taishita	considerable;great;important;significant;a big deal
対象	たいしょう	taishou	target;object (of worship; study; etc);subject (of taxation; etc)
大臣	だいじん	daijin	cabinet minister
対する	たいする	taisuru	to face;to confront;to oppose
大戦	たいせん	taisen	great war;great battle
大抵	たいてい	taitei	usually;generally
態度	たいど	taido	attitude;manner
大統領	だいとうりょう	daitouryou	president;chief executive
大半	たいはん	taihan	majority;mostly;generally
代表	だいひょう	daihyou	representative;representation;delegation;type;example;model
大部分	だいぶぶん	daibubun	most part;greater part;majority
	タイプライター	taipuraitaa	typewriter
大変	たいへん	taihen	awful;dreadful;terrible;very
逮捕	たいほ	taiho	arrest;apprehension;capture
	ダイヤ	daiya	(1) dyer;(2) diagram;(3) (railway) schedule;(4) diamond
太陽	たいよう	taiyou	sun;solar
平ら	たいら	taira	flatness;level;smooth;calm;plain
代理	だいり	dairi	representation;agency;proxy;deputy;agent
大陸	たいりく	tairiku	continent
倒す	たおす	taosu	to throw down;to beat;to bring down;to blow down
	タオル	taoru	(hand) towel
だが	だが	daga	but
互い	たがい	tagai	mutual;reciprocal
宝	たから	takara	treasure
だから	だから	dakara	so;therefore
宅	たく	taku	house;home;husband
	だけど	dakedo	however
確かめる	たしかめる	tashikameru	to ascertain
多少	たしょう	tashou	more or less;somewhat;a little;some
助ける	たすける	tasukeru	to help;to save;to rescue
唯	ただ	tada	free of charge;mere;sole;only;usual;common
戦い	たたかい	tatakai	battle;fight;struggle;conflict
戦う	たたかう	tatakau	to fight;to battle;to combat
叩く	たたく	tataku	to strike;to clap;to dust;to beat
直ちに	ただちに	tadachini	at once;immediately;directly;in person
立ち上がる	たちあがる	tachiagaru	to stand up
立場	たちば	tachiba	standpoint;position;situation
経つ	たつ	tatsu	to pass;to lapse
達する	たっする	tassuru	to reach;to get to
唯	たった	tatta	free of charge;mere;sole;only;usual;common
	だって	datte	but;because;even;also;too
	たっぷり	tappuri	full;in plenty;ample
縦	たて	tate	length;height
	たとえ	tatoe	simile;metaphor;allegory
谷	たに	tani	valley
他人	たにん	tanin	another person;unrelated person;outsider;stranger
種	たね	tane	(1) seed;(2) material;(3) cause;source
束	たば	taba	handbreadth;bundle
度	たび	tabi	counter for occurrences
旅	たび	tabi	travel;trip;journey
	たびたび	tabitabi	often;repeatedly;frequently
多分	たぶん	tabun	perhaps;probably
玉	たま	tama	ball;sphere;coin
球	たま	tama	globe;sphere;ball
弾	たま	tama	bullet;shot;shell
偶	たま	tama	even number;couple;man and wife;friend
偶々	たまたま	tamatama	casually;unexpectedly;accidentally;by chance
	たまらない	tamaranai	intolerable;unbearable;unendurable
黙る	だまる	damaru	to be silent
駄目	だめ	dame	useless;no good;hopeless
試し	ためし	tameshi	trial;test
試す	ためす	tamesu	to attempt;to test
便り	たより	tayori	news;tidings;information;correspondence;letter
頼る	たよる	tayoru	to rely on;to have recourse to;to depend on
誰か	だれか	dareka	someone;somebody
段	だん	dan	step;stair;flight of steps;grade;rank;level
単位	たんい	tani	unit;denomination;credit (in school)
単語	たんご	tango	word;vocabulary;(usually) single-character word
男子	だんし	danshi	youth;young man
単純	たんじゅん	tanjun	simplicity
誕生	たんじょう	tanjou	birth
	ダンス	dansu	dance
団体	だんたい	dantai	organization;association
担当	たんとう	tantou	(in) charge
単なる	たんなる	tannaru	mere;simple;sheer
単に	たんに	tanni	simply;merely;only;solely
地	ち	chi	earth
地位	ちい	chii	(social) position;status
地域	ちいき	chiiki	area;region
	チーズ	chiizu	cheese
	チーム	chiimu	team
知恵	ちえ	chie	wisdom;wit;sagacity;sense;intelligence;advice
地下	ちか	chika	basement;underground
違い	ちがい	chigai	difference;discrepancy
違いない	ちがいない	chigainai	(phrase) sure;no mistaking it;for certain
近頃	ちかごろ	chikagoro	lately;recently;nowadays
地球	ちきゅう	chikyuu	the earth
地区	ちく	chiku	district;section;sector
遅刻	ちこく	chikoku	lateness;late coming
知事	ちじ	chiji	prefectural governor
知識	ちしき	chishiki	knowledge;information
父親	ちちおや	chichioya	father
知能	ちのう	chinou	intelligence;brains
地平線	ちへいせん	chiheisen	horizon
地方	ちほう	chihou	area;locality;district;region;the coast
茶	ちゃ	cha	tea
	チャンス	chansu	chance;opportunity
	ちゃんと	chanto	perfectly;properly;exactly
中	ちゅう	chuu	inside;middle;among
注	ちゅう	chuu	annotation;explanatory note
中央	ちゅうおう	chuuou	centre;central;center;middle
中学	ちゅうがく	chuugaku	middle school;junior high school
中古	ちゅうこ	chuuko	(1) used;second-hand;old
中止	ちゅうし	chuushi	suspension;stoppage;discontinuance;interruption
駐車	ちゅうしゃ	chuusha	parking (e.g. car)
昼食	ちゅうしょく	chuushoku	lunch;midday meal
中心	ちゅうしん	chuushin	center;core;heart;pivot;emphasis;balance
注目	ちゅうもく	chuumoku	notice;attention;observation
注文	ちゅうもん	chuumon	order;request
長期	ちょうき	chouki	long time period
調査	ちょうさ	chousa	investigation;examination;inquiry;survey
調子	ちょうし	choushi	tune;tone;key
頂上	ちょうじょう	choujou	top;summit;peak
	ちょうだい	choudai	(1) please do for me (preceded by -te);(2) reception;being given;get
貯金	ちょきん	chokin	(bank) savings
直接	ちょくせつ	chokusetsu	direct;immediate;personal;firsthand
著者	ちょしゃ	chosha	author;writer
遂に	ついに	tsuini	finally;at last
通過	つうか	tsuuka	passage through;passing
通学	つうがく	tsuugaku	commuting to school
通行	つうこう	tsuukou	passage;passing
通じる	つうじる	tsuujiru	to run to;to lead to;to communicate;to understand
通信	つうしん	tsuushin	correspondence;communication;news;signal
捕まる	つかまる	tsukamaru	to be caught;to be arrested
掴む	つかむ	tsukamu	to seize;to catch;to grasp
疲れ	つかれ	tsukare	tiredness;fatigue
月	つき	tsuki	moon;month
付き合い	つきあい	tsukiai	association;socializing;fellowship
次々	つぎつぎ	tsugitsugi	in succession;one by one
就く	つく	tsuku	to settle in (place);to take (seat; position);to study (under teacher)
注ぐ	つぐ	tsugu	to pour (into);to irrigate;to pay
付ける	つける	tsukeru	to attach;to join;to add;to append
土	つち	tsuchi	earth;soil
続き	つづき	tsuzuki	sequel;continuation
包み	つつみ	tsutsumi	bundle;package;parcel;bale
勤め/務め	つとめ	tsutome	(1) service;duty;business;responsibility;task;(2) Buddhist religious services
繋ぐ	つなぐ	tsunagu	to tie;to fasten;to connect;to transfer (phone call)
常に	つねに	tsuneni	always;constantly
翼	つばさ	tsubasa	wings
	つまり	tsumari	in short;in brief;in other words
罪	つみ	tsumi	crime;fault;indiscretion
詰める	つめる	tsumeru	to pack;to shorten;to work out (details)
積もる	つもる	tsumoru	to pile up
梅雨	つゆ	tsuyu	rainy season;rain during the rainy season
辛い	つらい	tsurai	painful;heart-breaking
釣	つり	tsuri	Fishing
連れ	つれ	tsure	companion;company
出会い	であい	deai	meeting;rendezvous;encounter
出会う	であう	deau	to meet by chance;to come across;to happen to encounter
提案	ていあん	teian	proposal;proposition;suggestion
定期	ていき	teiki	fixed term
抵抗	ていこう	teikou	electrical resistance;resistance;opposition
提出	ていしゅつ	teishutsu	presentation;submission;filing
程度	ていど	teido	degree;amount;grade;standard;of the order of (following a number)
停留所	ていりゅうじょ	teiryuujo	bus or tram stop
	デート	deeto	date;go on a date
敵	てき	teki	enemy;rival
出来事	できごと	dekigoto	incident;affair;happening;event
適する	てきする	tekisuru	to fit;to suit
適切	てきせつ	tekisetsu	pertinent;appropriate;adequate;relevance
適度	てきど	tekido	moderate
適用	てきよう	tekiyou	applying
出来るだけ	できるだけ	dekirudake	if at all possible
	できれば	dekireba	If possible
手品	てじな	tejina	sleight of hand;conjuring trick;magic;juggling
	ですから	desukara	therefore
鉄	てつ	tetsu	iron
哲学	てつがく	tetsugaku	philosophy
手伝い	てつだい	tetsudai	help;helper;assistant
徹底	てってい	tettei	thoroughness;completeness
鉄道	てつどう	tetsudou	railroad
徹夜	てつや	tetsuya	all night;all night vigil;sleepless night
では	では	deha	chance of going out;opportunity (to succeed);moment of departure;beginning of work
手間	てま	tema	time;labour
でも	でも	demo	but;however
	デモ	demo	(abbr) demo;demonstration
典型	てんけい	tenkei	type;pattern;archetypal
天候	てんこう	tenkou	weather
電子	でんし	denshi	electron
	テント	tento	tent
伝統	でんとう	dentou	tradition;convention
天然	てんねん	tennen	nature;spontaneity
度	ど	do	counter for occurrences
問い	とい	toi	question;query
党	とう	tou	party (political)
塔	とう	tou	tower;pagoda
	どう	dou	child;servant;foolishness
答案	とうあん	touan	examination paper;examination script
同一	どういつ	douitsu	identity;sameness;similarity
	どうか	douka	copper coin
当時	とうじ	touji	at that time;in those days
動詞	どうし	doushi	verb
同時	どうじ	douji	simultaneous(ly);concurrent;same time;synchronous
	どうしても	doushitemo	by all means;at any cost;no matter what
到着	とうちゃく	touchaku	arrival
道徳	どうとく	doutoku	morals
投票	とうひょう	touhyou	voting;poll
同様	どうよう	douyou	identical;equal to;same (kind);like
同僚	どうりょう	douryou	coworker;colleague;associate
道路	どうろ	douro	road;highway
十	とお	too	10;ten
通す	とおす	toosu	to let pass;to overlook;to continue
通り	とおり	toori	in accordance with ~;following ~;~ Street;~ Avenue
通り過ぎる	とおりすぎる	toorisugiru	to pass;to pass through
都会	とかい	tokai	city
時	とき	toki	(1) time;hour;(2) occasion;moment
解く	とく	toku	to unfasten
毒	どく	doku	poison;toxicant
得意	とくい	tokui	pride;triumph;prosperity
読書	どくしょ	dokusho	reading
独身	どくしん	dokushin	bachelorhood;single;unmarried;celibate
特徴	とくちょう	tokuchou	feature;characteristic
独特	どくとく	dokutoku	peculiarity;uniqueness;characteristic
独立	どくりつ	dokuritsu	independence (e.g. Ind. Day);self-support
解ける	とける	tokeru	to come untied;to come apart
	どこか	dokoka	somewhere;anywhere
	ところが	tokoroga	however;while;even if
	ところで	tokorode	by the way;even if;no matter what
登山	とざん	tozan	mountain-climbing
都市	とし	toshi	town;city;municipal;urban
年月	としつき	toshitsuki	months and years
図書	としょ	tosho	books
年寄	としより	toshiyori	old people;the aged
閉じる	とじる	tojiru	to close (e.g. book; eyes);to shut
途端	とたん	totan	just (now; at the moment; etc.)
土地	とち	tochi	plot of land;lot;soil
突然	とつぜん	totsuzen	abruptly;suddenly;unexpectedly;all at once
	トップ	toppu	top
届く	とどく	todoku	to reach
	とにかく	tonikaku	anyhow;at any rate;anyway;somehow or other;generally speaking;in any case
飛ばす	とばす	tobasu	to skip over;to omit
飛び出す	とびだす	tobidasu	to jump out;to rush out;to fly out
留める	とめる	tomeru	to fasten;to turn off;to detain
友	とも	tomo	friend;companion;pal
共に	ともに	tomoni	sharing with;participate in
土曜	どよう	doyou	Saturday
虎	とら	tora	tiger
	ドライブ	doraibu	drive;trip by car;driving
	トラック	torakku	(1) truck;(2) (running) track
	ドラマ	dorama	drama
	トランプ	toranpu	playing cards (lit; trump)
取り上げる	とりあげる	toriageru	to take up;to pick up;to disqualify;to confiscate;to deprive
努力	どりょく	doryoku	great effort;exertion;endeavour;effort
どれ	どれ	dore	well;now;let me see;which (of three or more)
	ドレス	doresu	dress
取れる	とれる	toreru	to come off;to be taken off;to be removed
泥	どろ	doro	mud
	とん	ton	ton
	とんでもない	tondemonai	unexpected;offensive;What a thing to say!;No way!
	どんな	donna	what;what kind of
	どんなに	donnani	how;how much
	トンネル	tonneru	tunnel
名	な	na	name;reputation
内容	ないよう	naiyou	subject;contents;matter;substance;detail;import
	なお	nao	straight;mischief;ordinary;common
仲	なか	naka	relation;relationship
流す	ながす	nagasu	to drain;to float;to shed (blood; tears);to cruise (e.g. taxi)
	なかなか	nakanaka	very;considerably;easily
半ば	なかば	nakaba	middle;half;semi;halfway;partly
仲間	なかま	nakama	company;fellow;colleague;associate
眺め	ながめ	nagame	scene;view;prospect;outlook
眺める	ながめる	nagameru	to view;to gaze at
流れ	ながれ	nagare	stream;current
流れる	ながれる	nagareru	to stream;to flow;to run (ink);to be washed away
無し	なし	nashi	without
	なぜなら	nazenara	because
謎	なぞ	nazo	riddle;puzzle;enigma
納得	なっとく	nattoku	consent;assent;understanding
等	など	nado	et cetera;etc.;and the like
何か	なにか	nanika	something
	なにも	nanimo	nothing
鍋	なべ	nabe	saucepan;pot
生	なま	nama	(1) draft (beer);(2) raw;unprocessed
怠ける	なまける	namakeru	to be idle;to neglect
波	なみ	nami	wave
涙	なみだ	namida	tear
悩む	なやむ	nayamu	to be worried;to be troubled
為る/成る	なる	naru	to become
縄	なわ	nawa	rope;hemp
何で	なんで	nande	Why?;What for?
何でも	なんでも	nandemo	by all means;everything
何とか	なんとか	nantoka	somehow;anyhow;one way or another
似合う	にあう	niau	to suit;to match;to become;to be like
匂い	におい	nioi	odour;scent;smell;stench
苦手	にがて	nigate	poor (at);weak (in);dislike (of)
握る	にぎる	nigiru	to grasp;to seize;to mould sushi
日	にち	nichi	sun;sunshine;day
日常	にちじょう	nichijou	ordinary;regular;everyday;usual
日曜	にちよう	nichiyou	Sunday
日光	にっこう	nikkou	sunlight
日中	にっちゅう	nicchuu	daytime;broad daylight
	にっこり	nikkori	smile sweetly;smile;grin
入院	にゅういん	nyuuin	hospitalization
入学	にゅうがく	nyuugaku	entry to school or university;matriculation
入場	にゅうじょう	nyuujou	entrance;admission;entering
人気	にんき	ninki	sign of life
人間	にんげん	ningen	human being;man;person
抜く	ぬく	nuku	to extract;to omit;to surpass;to draw out;to unplug
抜ける	ぬける	nukeru	to come out;to fall out;to be omitted
布	ぬの	nuno	cloth
濡れる	ぬれる	nureru	to get wet
	ね	ne	value;price;cost;worth;merit
根	ね	ne	root
値	ね	ne	value;price;cost
願い	ねがい	negai	desire;wish;request
願う	ねがう	negau	to desire;to wish;to request
鼠	ねずみ	nezumi	(1) mouse;rat;(2) dark gray;slate color
値段	ねだん	nedan	price;cost
熱心	ねっしん	nesshin	zeal;enthusiasm
熱帯	ねったい	nettai	tropics
熱中	ねっちゅう	necchuu	nuts!;enthusiasm;zeal;mania
年間	ねんかん	nenkan	year
年月	ねんげつ	nengetsu	months and years
年中	ねんじゅう	nenjuu	whole year;always;everyday
年代	ねんだい	nendai	age;era;period;date
年齢	ねんれい	nenrei	age;years
野	の	no	field
能	のう	nou	being skilled in;nicely;properly
農家	のうか	nouka	farmer;farm family
農業	のうぎょう	nougyou	agriculture
農民	のうみん	noumin	farmers;peasants
能力	のうりょく	nouryoku	ability;faculty
	ノー	no	no
軒	のき	noki	eaves
残す	のこす	nokosu	to leave (behind; over);to bequeath;to save;to reserve
残り	のこり	nokori	remnant;residue;remaining;left-over
乗せる	のせる	noseru	to place on (something);to take on board;to give a ride
除く	のぞく	nozoku	to remove;to exclude;to except
望み	のぞみ	nozomi	wish;desire;(a) hope
望む	のぞむ	nozomu	to desire;to wish for;to see;to command (a view of)
後	のち	nochi	afterwards;since then;in the future
	ノック	nokku	(1) knock;(2) fungo (baseball)
喉	のど	nodo	throat
伸ばす	のばす	nobasu	to lengthen;to stretch;to reach out;to grow (beard)
伸びる	のびる	nobiru	to stretch;to extend;to make progress;to grow (beard; body height)
述べる	のべる	noberu	to state;to express;to mention
昇る	のぼる	noboru	to arise;to ascend;to go up
	のんびり	nonbiri	carefree;at leisure
場	ば	ba	place;field (physics)
	はあ	haa	interjection “aa”
	パーセント	paasento	percent
	はい	hai	wear;put on (sword)
灰	はい	hai	ash
梅雨	ばいう	baiu	rainy season;rain during the rainy season
	バイオリン	baiorin	violin
	ハイキング	haikingu	hiking
配達	はいたつ	haitatsu	delivery;distribution
	パイプ	paipu	(1) pipe;tube;(2) channels; official or otherwise
俳優	はいゆう	haiyuu	actor;actress;player;performer
	パイロット	pairotto	pilot
墓	はか	haka	grave;tomb
馬鹿	ばか	baka	fool;idiot;trivial matter;folly
博士	はかせ	hakase	doctorate;PhD
計る	はかる	hakaru	to measure;to weigh;to survey
履く	はく	haku	to wear;to put on (lower body)
吐く	はく	haku	(1) to breathe;(2) to tell (lies);(3) to vomit;to disgorge
拍手	はくしゅ	hakushu	clapping hands;applause
莫大	ばくだい	bakudai	enormous;vast
爆発	ばくはつ	bakuhatsu	explosion;detonation;eruption
博物館	はくぶつかん	hakubutsukan	museum
激しい	はげしい	hageshii	violent;vehement;intense
	はさみ	hasami	scissors
破産	はさん	hasan	(personal) bankruptcy
端	はし	hashi	end (e.g. of street);edge;tip;margin;point
始まり	はじまり	hajimari	origin;beginning
	パス	pasu	path;pass (in games)
外す	はずす	hazusu	to unfasten;to remove
	パスポート	pasupooto	passport
旗	はた	hata	flag
肌	はだ	hada	skin
裸	はだか	hadaka	naked;nude
畑	はたけ	hatake	field
二十	はたち	hatachi	20 years old;20th year
働き	はたらき	hataraki	work;labor
	バッグ	baggu	bag;bug
発見	はっけん	hakken	discovery;detection;finding
発行	はっこう	hakkou	issue (publications)
発車	はっしゃ	hassha	departure of a vehicle
罰する	ばっする	bassuru	to punish;to penalize
発達	はったつ	hattatsu	development;growth
	ばったり	battari	with a clash (thud);with a bang;plump;flop
発展	はってん	hatten	development;growth
発表	はっぴょう	happyou	announcement;publication
発明	はつめい	hatsumei	invention
話し合う	はなしあう	hanashiau	to discuss;to talk together
離す	はなす	hanasu	to part;divide;separate
放す	はなす	hanasu	to separate;to set free
離れる	はなれる	hanareru	to be separated from;to leave;to go away;to be a long way off
羽	はね	hane	counter for birds;counter for rabbits
幅	はば	haba	width;breadth
母親	ははおや	hahaoya	mother
省く	はぶく	habuku	to omit;to eliminate;to curtail;to economize
場面	ばめん	bamen	scene;setting (e.g. of novel)
腹	はら	hara	abdomen;belly;stomach
原	はら	hara	field;plain;prairie;tundra;moor;wilderness
針	はり	hari	needle;hand (e.g. clock)
張る	はる	haru	to stick;to paste
番	ばん	ban	number
	バン	ban	bun;van (caravan);VAN (value-added network)
範囲	はんい	hani	extent;scope;sphere;range
反抗	はんこう	hankou	opposition;resistance
犯罪	はんざい	hanzai	crime
	ハンサム	hansamu	handsome
判断	はんだん	handan	judgement;decision
犯人	はんにん	hannin	offender;criminal
販売	はんばい	hanbai	sale;selling;marketing
灯	ひ	hi	light
	ビール	biiru	beer
被害	ひがい	higai	damage
比較	ひかく	hikaku	comparison
轢く	ひく	hiku	to run somebody over (with vehicle);to knock someone down
	ピクニック	pikunikku	picnic
悲劇	ひげき	higeki	tragedy
飛行	ひこう	hikou	aviation
膝	ひざ	hiza	knee;lap
非常	ひじょう	hijou	emergency;extraordinary;unusual
美人	びじん	bijin	beautiful person (woman)
額	ひたい	hitai	forehead;brow
	びっくり	bikkuri	be surprised;be amazed;be frightened;astonishment
日付	ひづけ	hizuke	date;dating
必死	ひっし	hisshi	inevitable death;desperation;frantic;inevitable result
	ぴったり	pittari	exactly;neatly;sharp
引っ張る	ひっぱる	hipparu	(1) to pull;to draw;to stretch;to drag;(2) to pull the ball (baseball)
否定	ひてい	hitei	negation;denial;repudiation
	ビデオ	bideo	video
一言	ひとこと	hitokoto	single word
人込み	ひとごみ	hitogomi	crowd of people
等しい	ひとしい	hitoshii	equal
独り	ひとり	hitori	alone;unmarried
一人一人	ひとりひとり	hitorihitori	one by one;each;one at a time
批判	ひはん	hihan	criticism;judgement;comment
批評	ひひょう	hihyou	criticism;review;commentary
秘密	ひみつ	himitsu	secret;secrecy
微妙	びみょう	bimyou	delicate;subtle
紐	ひも	himo	(1) string;cord;(2) pimp
費用	ひよう	hiyou	cost;expense
表	ひょう	hyou	table (e.g. Tab 1);chart;list
秒	びょう	byou	second (60th min)
評価	ひょうか	hyouka	valuation;estimation;assessment;evaluation
表現	ひょうげん	hyougen	expression;presentation;representation (math)
表情	ひょうじょう	hyoujou	facial expression
平等	びょうどう	byoudou	equality (a);impartiality;evenness
評判	ひょうばん	hyouban	fame;reputation;popularity;arrant
表面	ひょうめん	hyoumen	surface;outside;face;appearance
広がる	ひろがる	hirogaru	to spread (out);to extend;to stretch;to reach to;to get around
瓶	びん	bin	bottle
便	びん	bin	way;means
	ピン	pin	pin
不	ふ(ぶ)	fu(bu)	un;non;negative prefix
無	ぶ	bu	nothing;naught;nil;zero
分	ぶ	bu	dividing;part
不安	ふあん	fuan	anxiety;uneasiness;insecurity;suspense
風景	ふうけい	fuukei	scenery
夫婦	ふうふ	fuufu	married couple;husband and wife
笛	ふえ	fue	flute;pipe
不可	ふか	fuka	wrong;bad;improper;unjustifiable;inadvisable
武器	ぶき	buki	weapon;arms;ordinance
服装	ふくそう	fukusou	garments
含む	ふくむ	fukumu	to hold in the mouth;to bear in mind
袋	ふくろ	fukuro	bag;sack
不幸	ふこう	fukou	unhappiness;sorrow;misfortune;disaster;accident;death
節	ふし	fushi	tune;tone;knot;knob;point
無事	ぶじ	buji	safety;peace;quietness
不思議	ふしぎ	fushigi	mystery;curiosity
不自由	ふじゆう	fujiyuu	discomfort;disability;inconvenience;destitution
夫人	ふじん	fujin	wife;Mrs;madam
婦人	ふじん	fujin	woman;female
不正	ふせい	fusei	injustice;unfairness
防ぐ	ふせぐ	fusegu	to defend (against);to protect;to prevent
不足	ふそく	fusoku	insufficiency;shortage;deficiency;lack;dearth
舞台	ぶたい	butai	stage (theatre)
双子	ふたご	futago	twins;a twin
再び	ふたたび	futatabi	again;once more;a second time
普段	ふだん	fudan	usually;habitually;ordinarily;always
縁	ふち	fuchi	a means; e.g. of living
打つ	ぶつ	butsu	to hit;to strike
物価	ぶっか	bukka	prices of commodities;prices (in general)
物質	ぶっしつ	busshitsu	material;substance
物理	ぶつり	butsuri	physics
筆	ふで	fude	writing brush
	ふと	futo	suddenly;casually;accidentally;incidentally;unexpectedly;unintentionally
船	ふね	fune	ship;boat;watercraft;shipping;vessel;steamship
部分	ぶぶん	bubun	portion;section;part
不平	ふへい	fuhei	complaint;discontent;dissatisfaction
不満	ふまん	fuman	dissatisfaction;displeasure;discontent;complaints;unhappiness
	プラス	purasu	plus
	プラン	puran	plan
不利	ふり	furi	disadvantage;handicap;unfavorable;drawback
振る	ふる	furu	(1) to wave;to shake;to swing;(2) to sprinkle;(3) to cast (actor);to allocate (work)
震える	ふるえる	furueru	to shiver;to shake;to quake
	ブレーキ	bureeki	a brake
触れる	ふれる	fureru	to touch;to be touched;to touch on a subject;to feel;to violate (law; copyright; etc.);to perceive;t
風呂	ふろ	furo	bath
	プロ	puro	professional
分	ぶん	bun	dividing;part;segment
文	ぶん	bun	sentence
雰囲気	ふんいき	funiki	atmosphere (e.g. musical);mood;ambience
分析	ぶんせき	bunseki	analysis
文明	ぶんめい	bunmei	civilization;culture
分野	ぶんや	bunya	field;sphere;realm;division;branch
塀	へい	hei	wall;fence
平均	へいきん	heikin	equilibrium;balance;average;mean
平和	へいわ	heiwa	peace;harmony
別に	べつに	betsuni	(not) particularly;nothing
減らす	へらす	herasu	to abate;to decrease;to diminish;to shorten
減る	へる	heru	to decrease (in size or number);to diminish;to abate
	ベルト	beruto	Belt for western clothes
変化	へんか	henka	goblin;ghost;apparition;bugbear
	ペンキ	penki	(n) paint (nl; pek)
勉強	べんきょう	benkyou	study;diligence;discount;reduction
変更	へんこう	henkou	change;modification;alteration
	ベンチ	benchi	bench
方	ほう	hou	side
法	ほう	hou	Act (law; the X Act)
棒	ぼう	bou	pole;rod;stick
冒険	ぼうけん	bouken	risk;venture;adventure
方向	ほうこう	houkou	direction;course;way
報告	ほうこく	houkoku	report;information
宝石	ほうせき	houseki	gem;jewel
放送	ほうそう	housou	broadcast;broadcasting
豊富	ほうふ	houfu	abundance;wealth;plenty;bounty
方法	ほうほう	houhou	method;manner;way;means;technique
方々	ほうぼう	houbou	persons;this and that;here and there;everywhere
訪問	ほうもん	houmon	call;visit
吠える	ほえる	hoeru	to bark;to bay;to howl;to bellow;to roar;to cry
	ボーイ	booi	boy
	ボート	booto	rowing boat
	ホーム	hoomu	(1) platform;(2) home
	ボール	booru	ball;bowl
他	ほか	hoka	other (esp. places and things)
外	ほか	hoka	other place;the rest
誇り	ほこり	hokori	pride
埃	ほこり	hokori	dust
保証	ほしょう	hoshou	guarantee;security;assurance;pledge;warranty
保存	ほぞん	hozon	preservation;conservation;storage;maintenance
程	ほど	hodo	degree;extent;bounds;limit
歩道	ほどう	hodou	footpath;walkway;sidewalk
仏	ほとけ	hotoke	Buddha;merciful person;Buddhist image;the dead
骨	ほね	hone	bone
炎	ほのお	honoo	flame
頬	ほほ(ほお)	hoho(hoo)	cheek (of face)
	ほぼ	hobo	almost;roughly;approximately
微笑む	ほほえむ	hohoemu	to smile
褒める	ほめる	homeru	to praise;to admire;to speak well
濠	ほり	hori	moat
本当	ほんと(ほんとう)	honto(hontou)	truth;reality
本人	ほんにん	honnin	the person himself
本物	ほんもの	honmono	genuine article
	ぼんやり	bonyari	absent-minded;block-head;dim;faint;vague
間	ま	ma	space;room;time;pause
	まあ	maa	(female) you might say
	マーケット	maaketto	market
	マイク	maiku	mike
迷子	まいご	maigo	lost (stray) child
任せる	まかせる	makaseru	to entrust to another;to leave to
幕	まく	maku	curtain;bunting;act (in play)
負け	まけ	make	defeat;loss;losing (a game)
孫	まご	mago	grandchild
	まさか	masaka	by no means
	まさに	masani	correctly;surely
真面目	まじめ	majime	diligent;serious;honest
増す	ます	masu	to increase;to grow
先ず	まず	mazu	first (of all);to start with;about;almost;hardly (with neg. verb)
貧しい	まずしい	mazushii	poor;needy
	マスター	masutaa	proprietor;manager;barowner;master (e.g. arts; science)
	ますます	masumasu	increasingly;more and more
又	また	mata	again;and
未だ	まだ	mada	yet;still;more;besides
街	まち	machi	(1) town;(2) street;road
間違い	まちがい	machigai	mistake
松	まつ	matsu	(1) pine tree;(2) highest (of a three-tier ranking system)
真っ赤	まっか	makka	deep red;flushed (of face)
真っ直ぐ	まっすぐ	massugu	straight (ahead);direct;upright
全く	まったく	mattaku	really;truly;entirely;completely
祭	まつり	matsuri	festival;feast
学ぶ	まなぶ	manabu	to study (in depth);to learn;to take lessons in
真似	まね	mane	mimicry;imitation;behavior;pretense
招く	まねく	maneku	to invite
	ママ	mama	Mama
豆	まめ	mame	beans;peas
守る	まもる	mamoru	to protect;to obey;to guard;to abide (by the rules)
丸	まる	maru	circle;full (month);perfection;purity;suffix for ship names
円	まる	maru	circle;money
丸い	まるい	marui	round;circular;spherical
	まるで	marude	quite;entirely;completely
回す	まわす	mawasu	to turn;to revolve
回り	まわり	mawari	circumference;surroundings;circulation
万一	まんいち	manichi	by some chance;by some possibility;if by any chance;10^E4
満足	まんぞく	manzoku	satisfaction
身	み	mi	body;main part;oneself;sword
実	み	mi	fruit;nut;seed;content;good result
見送り	みおくり	miokuri	seeing one off;farewell;escort
味方	みかた	mikata	friend;ally;supporter
見事	みごと	migoto	splendid;magnificent;beautiful;admirable
	ミス	misu	miss (mistake; error; failure);Miss
満ちる	みちる	michiru	to be full;to rise (tide);to mature;to expire
密	みつ	mitsu	secret
認める	みとめる	mitomeru	to recognize;to appreciate;to approve;to admit;to notice
皆	みんな	minna	all;everyone;everybody
見舞い	みまい	mimai	enquiry;expression of sympathy;expression of concern
土産	みやげ	miyage	present;souvenir
都	みやこ	miyako	capital
妙	みょう	myou	strange;unusual
明後日	みょうごにち	myougonichi	day after tomorrow
未来	みらい	mirai	future (life; tense)
魅力	みりょく	miryoku	charm;fascination;glamour
	ミルク	miruku	milk
無	む	mu	nothing;naught;nil;zero
向かい	むかい	mukai	facing;opposite;across the street;other side
迎え	むかえ	mukae	meeting;person sent to pick up an arrival
向く	むく	muku	to face
向ける	むける	mukeru	to turn towards;to point
無視	むし	mushi	disregard;ignore
虫歯	むしば	mushiba	cavity;tooth decay;decayed tooth;caries
寧ろ	むしろ	mushiro	rather;better;instead
結ぶ	むすぶ	musubu	to tie;to bind;to link
無駄	むだ	muda	futility;uselessness
夢中	むちゅう	muchuu	daze;(in a) trance;ecstasy;delirium;engrossment
胸	むね	mune	breast;chest
無料	むりょう	muryou	free;no charge
芽	め	me	sprout
明確	めいかく	meikaku	clear up;clarify;define
命じる	めいじる	meijiru	to order;to command;to appoint
名人	めいじん	meijin	master;expert
命令	めいれい	meirei	order;command;decree;directive;(software) instruction
迷惑	めいわく	meiwaku	trouble;bother;annoyance
飯	めし	meshi	(sl) meals;food
滅多に	めったに	mettani	rarely (with neg. verb);seldom
	メモ	memo	memorandum
面	めん	men	face;mug;surface;facial features;mask;face guard;side or facet;corner;page
綿	めん	men	cotton;padding
免許	めんきょ	menkyo	license;permit;licence;certificate
面倒	めんどう	mendou	trouble;difficulty;care;attention
	メンバー	menbaa	member
申し込む	もうしこむ	moushikomu	to apply for;to make an application
申し訳	もうしわけ	moushiwake	apology;excuse
毛布	もうふ	moufu	blanket
燃える	もえる	moeru	to burn
目的	もくてき	mokuteki	purpose;goal;aim;objective;intention
目標	もくひょう	mokuhyou	mark;objective;target
木曜	もくよう	mokuyou	Thursday
文字	もじ(もんじ)	moji(monji)	letter (of alphabet);character
	もしも	moshimo	if
持ち上げる	もちあげる	mochiageru	to raise;to lift up;to flatter
用いる	もちいる	mochiiru	to use;to make use of
勿論	もちろん	mochiron	of course;certainly;naturally
最も	もっとも	mottomo	most;extremely
尤も	もっとも	mottomo	quite right;plausible;natural;but then;although
元	もと	moto	(1) origin;original;(2) former
基	もと	moto	basis
素	もと	moto	prime
戻す	もどす	modosu	to restore;to put back;to return
基づく	もとづく	motozuku	to be grounded on;to be based on;to be due to;to originate from
求める	もとめる	motomeru	to seek;to request;to demand;to want;to wish for;to search for;to pursue (pleasure);to hunt (a job);
者	もの	mono	person
物音	ものおと	monooto	sounds
物語	ものがたり	monogatari	tale;story;legend
物事	ものごと	monogoto	things;everything
模様	もよう	moyou	pattern;figure;design
貰う	もらう	morau	to receive
文句	もんく	monku	phrase;complaint
	やがて	yagate	before long;soon;at length
役	やく	yaku	use;service;role;position
約	やく	yaku	approximately;about;some
訳	やく	yaku	meaning;reason;circumstances;can be deduced;situation
役割	やくわり	yakuwari	part;assigning (allotment of) parts;role;duties
家賃	やちん	yachin	rent
厄介	やっかい	yakkai	trouble;burden;care;bother
宿	やど	yado	inn;lodging
雇う	やとう	yatou	to employ;to hire
屋根	やね	yane	roof
	やはり	yahari	also;as I thought;still;in spite of;absolutely;of course
破る	やぶる	yaburu	to tear;to violate;to defeat;to smash;to destroy
辞める	やめる	yameru	to retire
	やや	yaya	a little;partially;somewhat;a short time;a while
唯一	ゆいいつ	yuiitsu	only;sole;unique
勇気	ゆうき	yuuki	courage;bravery;valour;nerve;boldness
有効	ゆうこう	yuukou	validity;availability;effectiveness
優秀	ゆうしゅう	yuushuu	superiority;excellence
優勝	ゆうしょう	yuushou	overall victory;championship
友情	ゆうじょう	yuujou	friendship;fellowship
友人	ゆうじん	yuujin	friend
有能	ゆうのう	yuunou	able;capable;efficient;skill
郵便	ゆうびん	yuubin	mail;postal service
夕べ	ゆうべ	yuube	evening
	ユーモア	yuumoa	humor
有利	ゆうり	yuuri	advantageous;better;profitable;lucrative
床	ゆか	yuka	floor
愉快	ゆかい	yukai	pleasant;happy
輸出	ゆしゅつ	yushutsu	export
譲る	ゆずる	yuzuru	to turn over;to assign;to hand over
豊か	ゆたか	yutaka	abundant;wealthy;plentiful;rich
	ゆっくり	yukkuri	slowly;at ease
輸入	ゆにゅう	yunyuu	importation;import;introduction
許す	ゆるす	yurusu	to permit;to allow;to approve
夜	よ	yo	evening;night
夜明け	よあけ	yoake	dawn;daybreak
様	よう	you	way;manner;kind
酔う	よう	you	to get drunk;to become intoxicated
容易	ようい	youi	easy;simple;plain
陽気	ようき	youki	season;weather;cheerfulness
要求	ようきゅう	youkyuu	request;demand;requisition
用心	ようじん	youjin	care;precaution;guarding;caution
様子	ようす	yousu	aspect;state;appearance
要するに	ようするに	yousuruni	in a word;after all;the point is ..;in short ..
要素	ようそ	youso	element
要点	ようてん	youten	gist;main point
曜日	ようび	youbi	day of the week
	ヨーロッパ	yooroppa	Europe
予期	よき	yoki	expectation;assume will happen;forecast
横切る	よこぎる	yokogiru	to cross (e.g. arms);to traverse
予算	よさん	yosan	estimate;budget
止す	よす	yosu	to cease;to abolish;to resign;to give up
予測	よそく	yosoku	prediction;estimation
	ヨット	yotto	yacht
夜中	よなか	yonaka	midnight;dead of night
世の中	よのなか	yononaka	society;the world;the times
余分	よぶん	yobun	extra;excess;surplus
予報	よほう	yohou	forecast;prediction
予防	よぼう	yobou	prevention;precaution;protection against
読み	よみ	yomi	reading
嫁	よめ	yome	bride;daughter-in-law
余裕	よゆう	yoyuu	surplus;composure;margin;room;time;allowance;scope;rope
	より	yori	twist;ply
	よると	yoruto	according to
喜び	よろこび	yorokobi	(a) joy;(a) delight;rapture;pleasure;gratification;rejoicing;congratulations;felicitations
宜しい	よろしい	yoroshii	(hon) good;OK;all right;fine;very well;will do;may;can
	よろしく	yoroshku	well;properly;suitably;best regards;please remember me
四	よん	yon	four
来	らい	rai	;for (10 days);next (year)
	ライター	raitaa	lighter;rider;writer
楽	らく	raku	comfort;ease
	ラケット	raketto	paddle;racket
利益	りえき	rieki	profits;gains;(political; economic) interest
理解	りかい	rikai	understanding;comprehension
陸	りく	riku	six (used in legal documents)
利口	りこう	rikou	clever;shrewd;bright;sharp;wise;intelligent
離婚	りこん	rikon	divorce
理想	りそう	risou	ideal
率	りつ	ritsu	rate;ratio;proportion;percentage
立派	りっぱ	rippa	splendid;fine;handsome;elegant;imposing;prominent;legal;legitimate
留学	りゅうがく	ryuugaku	studying abroad
流行	りゅうこう	ryuukou	fashionable;fad;in vogue;prevailing
量	りょう	ryou	quantity;amount;volume;portion (of food)
両替	りょうがえ	ryougae	change;money exchange
料金	りょうきん	ryoukin	fee;charge;fare
例	れい	rei	instance;example;case
礼	れい	rei	expression of gratitude
礼儀	れいぎ	reigi	manners;courtesy;etiquette
冷静	れいせい	reisei	calm;composure;coolness;serenity
列	れつ	retsu	queue;line;row
列車	れっしゃ	ressha	train (ordinary)
	レポート	repooto	report;paper
練習	れんしゅう	renshuu	practice
連想	れんそう	rensou	association (of ideas);suggestion
連続	れんぞく	renzoku	serial;consecutive;continuity;continuing
労働	ろうどう	roudou	manual labor;toil;work
	ロケット	roketto	locket;rocket
論じる	ろんじる	ronjiru	to argue;to discuss;to debate
論争	ろんそう	ronsou	controversy;dispute
論文	ろんぶん	ronbun	thesis;essay;treatise;paper
輪	わ	wa	ring;hoop;circle
	ワイン	wain	wine
	わがまま	wagamama	selfishness;egoism;wilfulness;disobedience;whim
別れ	わかれ	wakare	parting;separation;farewell
脇	わき	waki	side
分ける	わける	wakeru	to divide;to separate
	わざと	wazato	on purpose
僅か	わずか	wazuka	only;merely;a little;small quantity
綿	わた	wata	cotton;padding
話題	わだい	wadai	topic;subject
笑い	わらい	warai	laugh;laughter;smile
割る	わる	waru	to divide;to cut;to break;to halve
悪口	わるくち	warukuchi	abuse;insult;slander;evil speaking
我々	われわれ	wareware	we
湾	わん	wan	bay;gulf;inlet