	あっ	a	ах
愛	あい	ai	любовь
挨拶	あいさつ	aisatsu	приветствие; приветствие
愛情	あいじょう	aijou	любовь; любовь
合図	あいず	aizu	сигнал
	アイスクリーム	aisukuriimu	мороженое
愛する	あいする	aisuru	любить
相手	あいて	aite	партнер; оппонент
	あいにく	ainiku	к сожалению ; но ....
	アイロン	airon	утюг
	アウト	auto	вне
明かり	あかり	akari	свет лампы, свет (в общем); яркость
空き	あき	aki	комната; свободноге время; пустота
明らか	あきらか	akiraka	очевидно; ясно
諦める	あきらめる	akirameru	отказываться от; сдаваться
飽きる	あきる	akiru	надоедать; терять интерес к; иметь достаточно
握手	あくしゅ	akushu	рукопожатие
悪魔	あくま	akuma	демон; злой дух
明ける	あける	akeru	светать
	あした	ashita	завтра
預ける	あずける	azukeru	давать на время; сдавать на хранение
汗	あせ	ase	пот
与える	あたえる	ataeru	дать; представить; наградить
暖かい	あたたか(い)	atataka(i)	теплый 
辺り	あたり	atari	окрестности 
当たる	あたる	ataru	попадать; попадать (под дождь и т.п.); быть угаданным; иметь успех
	あちこち	achikochi	там и сям
扱う	あつかう	atsukau	обращаться; иметь дело с 
集まり	あつまり	atsumari	сбор; встреча; сборка; коллекция
当てる	あてる	ateru	ударить 
跡	あと	ato	след;руины;шрам
穴	あな	ana	отверстие
浴びる	あびる	abiru	купаться; чтобы погреться на солнце; принять душ
油	あぶら	abura	масло
余り	あまり	amari	не очень (используется как наречие); не так много
誤り	あやまり	ayamari	ошибка
粗	あら	ara	отбросы; недостаток 
嵐	あらし	arashi	буря 
新た	あらた	arata	новый; свежий 
	あらゆる	arayuru	всяческие; всевозможные
表す	あらわす	arawasu	выразить; показать; раскрыть
現す	あらわす	arawasu	показыать; указывать, отображать
現れ	あらわれ	araware	воплощение; материализация
現れる	あらわれる	arawareru	появляться; прийти в поле зрения; стать видимым 
有る	ある	aru	быть; находиться где-л
或	ある	aru	определенный, некоторый
	あるいは	aruiwa	или; либо; возможно же;
	アルバム	arubamu	альбом
泡	あわ	awa	пена 
合わせる	あわせる	awaseru	объединяться, быть напротив; объединить
哀れ	あわれ	aware	жаль; печаль; горе
案	あん	an	план; проект
暗記	あんき	anki	запоминание напамять
安定	あんてい	antei	стабильность; равновесие
案内	あんない	annai	введение; руководство 
	あんなに	annani	постольку, до такой степени
	あんまり	anmari	не очень; не так много; остаток; остальные
胃	い	i	желудок
	いい	ii	хорошо
	よい	yoi	хорошо, хороший; приятным; порядке
いえ	いえ	ie	нет (то же как いいえ)
委員	いいん	iin	член комитета
言う	ゆう	yuu	говорить
意外	いがい	igai	неожиданный
行き	いき(ゆき)	iki (yuki)	идущий
息	いき	iki	дыхание 
勢い	いきおい	ikioi	сила; энергетика; дух
生き物	いきもの	ikimono	живое существо 
幾つ	いくつ	ikutsu	сколько?; сколько лет?
幾ら	いくら	ikura	сколько? 
	いけない	ikenai	не надо это делать; неправильно 
医師	いし	ishi	врач
意思	いし	ishi	намерение; цель
意志	いし	ishi	воля
維持	いじ	iji	поддержка; охрана
意識	いしき	ishiki	сознание 
異常	いじょう	ijou	странность; аномалия 
椅子	いす	isu	стул
泉	いずみ	izumi	источник; ключ; родник
	いずれ	izure	какой; который
以前	いぜん	izen	прежде; предыдущий
板	いた	ita	доска; доски
偉大	いだい	idai	величие
抱く	いだく	idaku	охватывать; обниматьть;
	いたずら	itazura	дразнить; шалость; трюк; шутка
	いただきます	itadakimasu	выражение благодарности перед едой
頂く	いただく	itadaku	получать; принимать пищу или пить (вежливо)
痛み	いたみ	itami	боль
至る	いたる	itaru	приезжать; прибывать
	いち	ichi	рынок; ярмарка
位置	いち	ichi	место; положение; расположение
一時	いちじ	ichiji	момент, время
一度に	いちどに	ichidoni	внезапно
市場	いちば	ichiba	рынок (как понятие)
一番	いちばん	ichiban	лучший; первый; номер один
	いつか	itsuka	когда-то; когда-нибудь 
一家	いっか	ikka	дом;семья; домохозяйство
一種	いっしゅ	isshu	вид; род; разнообразие
一瞬	いっしゅん	isshun	момент; мгновенно
一生	いっしょう	isshou	вся жизнь;
一層	いっそう	issou	еще больше; все более
一体	いったい	ittai	один объект; действительно?; как правило,
一致	いっち	icchi	совпадение; соглашение 
	いつでも	itsudemo	(в) любое время, всегда; никогда (с отр)
一般	いっぱん	ippan	в целом; всеобщее; обычный
一方	いっぽう	ippou	с другой стороны; в то время; в свою очередь,
	いつまでも	itsumademo	навсегда; вечно; на неопределенный срок
いつも	いつも	itsumo	всегда; обычно; никогда (с отрицанием)
移動	いどう	idou	миграция; движение
従兄弟	いとこ	itoko	двоюродный брат (мужского пола)
稲	いね	ine	рис (на корню)
居眠り	いねむり	inemuri	дремота
命	いのち	inochi	приказ; жизнь; судьба
違反	いはん	ihan	нарушение
衣服	いふく	ifuku	одежда
居間	いま	ima	гостиная (в западном стиле)
今に	いまに	imani	в скором времени, и даже сейчас
今にも	いまにも	imanimo	в любое время, и вскоре
否	いや	iya	нет 
以来	いらい	irai	с; отныне
依頼	いらい	irai	запрос; просьба; доверие
	いらいら	iraira	раздраженный
	いらっしゃい	irasshai	добро пожаловать
医療	いりょう	iryou	медицинское обслуживание; лечение
岩	いわ	iwa	скала
祝い	いわい	iwai	празднование; фестиваль
祝う	いわう	iwau	поздравлять; праздновать
言わば	いわば	iwaba	так сказать
	いわゆる	iwayuru	так называемый; так сказать
	インク	inku	чернила
印刷	いんさつ	insatsu	печать
印象	いんしょう	inshou	впечатление
引退	いんたい	intai	уходить в отставку
引用	いんよう	inyou	цитата
	ウイスキー	uisukii	виски
上	うわ	uwa	Верхняя; внешний; поверхность
魚	うお	uo	рыба
	うがい	ugai	полоскание; прополоскать рот
伺う	うかがう	ukagau	(вежливо) посетщать; спрашивать
受け取る	うけとる	uketoru	получать; принимать 
動かす	うごかす	ugokasu	двигаться 
兎	うさぎ	usagi	кролик; заяц 
牛	うし	ushi	крупный рогатоый скот; корова
失う	うしなう	ushinau	терять; расставаться с
後	うしろ	ushiro	позади
嘘	うそ	uso	ложь
疑う	うたがう	utagau	сомневаться; не доверять; подозревать
内	うち	uchi	внутри
宇宙	うちゅう	uchuu	вселенная; космос 
撃つ	うつ	utsu	атаковать; уничтожать
移す	うつす	utsusu	удалять; передавать; заражать
訴える	うったえる	uttaeru	подавать в суд; прибегнуть к; обратиться к
	うなる	unaru	стонать 
奪う	うばう	ubau	отнимать; захватывать
馬	うま	uma	лошадь; перевернутый слон (сеги)
うまい	うまい	umai	восхитительный; вкусный
生まれ	うまれ	umare	рождение; место рождения
梅	うめ	ume	слива; низкий (в системах трехуровневого рейтинга)
裏切る	うらぎる	uragiru	предавать 
	うるさい	urusai	шумный; громкий; суетливый
嬉しい	うれしい	ureshii	счастливый; радостный; приятный
売れる	うれる	ureru	продавать
噂	うわさ	uwasa	слухи; сплетни 
運	うん	un	состояние; удача
運転	うんてん	unten	движение; вождение
運動	うんどう	undou	движение; упражнение (физическое)
柄	え	e	рукоятка; рычаг
永遠	えいえん	eien	вечность; постоянство
永久	えいきゅう	eikyuu	вечность 
影響	えいきょう	eikyou	влияние; эффект
営業	えいぎょう	eigyou	бизнес; торговля 
衛星	えいせい	eisei	спутник
栄養	えいよう	eiyou	питание
笑顔	えがお	egao	улыбка
描く	えがく	egaku	рисовать; описывать
餌	えさ	esa	корм; приманкиа
	エネルギー	enerugii	энергия
得る	える(うる)	eru(uru)	получать
円	えん	en	круг, деньги
延期	えんき	enki	отсрочка 
演技	えんぎ	engi	игра; исполнение 
援助	えんじょ	enjo	помощь; поддержка
	エンジン	enjin	двигатель
演説	えんぜつ	enzetsu	речь
演奏	えんそう	ensou	спектакль; исполнение
遠慮	えんりょ	enryo	стеснительность; сдержанность 
御	お	o	уважительная приставка
老い	おい	oi	старость; старый человек 
追い付く	おいつく	oitsuku	обогонять; догонять 
王	おう	ou	король; правитель; монарх
追う	おう	ou	преследовать; бежать за
王様	おうさま	ousama	король
王子	おうじ	ouji	принц
応じる	おうじる	oujiru	ответить; принимать (предложение); выполнять
横断	おうだん	oudan	пересечение
終える	おえる	oeru	заканчивать
大いに	おおいに	ooini	очень; значительно
覆う	おおう	oou	скрывать; оборачивать; маскировать
	オーバー	oobaa	пальто; над
大家	おおや	ooya	богатая семья; знаменитая школа
丘	おか	oka	холм; возвышение
沖	おき	oki	открытое море
奥	おく	oku	интерьер; внутренняя часть
贈る	おくる	okuru	давать; отправлять
起こる	おこる	okoru	происходить
幼い	おさない	osanai	очень молодой; детский
収める	おさめる	osameru	платить; поставлять; принимать
	おじいさん	ojiisan	дед; пожилой мужчина
	おしゃべり	oshaberi	болтовня 
汚染	おせん	osen	загрязнение
	おそらく	osoraku	возможно
恐れる	おそれる	osoreru	бояться
恐ろしい	おそろしい	osoroshii	ужасный; страшный
お互い	おたがい	otagai	взаимный; обратный
穏やか	おだやか	odayaka	спокойный; тихий
劣る	おとる	otoru	отставать, быть хуже
お腹	おなか	onaka	желудок
鬼	おに	oni	черт; демон 
帯	おび	obi	пояс (японский, широкий)
お昼	おひる	ohiru	обед; полдень
	オフィス	ofisu	офис
溺れる	おぼれる	oboreru	тонуть; перен. предаваться чему-л.
	おまえ	omae	(разг) ты 
	おめでとう	omedetou	поздравляю
お目に掛かる	おめにかかる	omenikakaru	(вежливо) чтобы видеть, встречаться
思い出	おもいで	omoide	воспоминание
主に	おもに	omoni	в основном, в первую очередь
思わず	おもわず	omowazu	непреднамеренно; спонтанно
	おや	oya	родители
泳ぎ	およぎ	oyogi	плавание
	およそ	oyoso	примерно; как правило 
及ぼす	およぼす	oyobosu	оказывать; осуществлять
居る	おる	oru	быть (об одушевленном); существовать
下す	おろす	orosu	снижать; отпусткать вниз
降ろす	おろす	orosu	давать сойти; спскать
終	おわり	owari	конец
音	おん	on	звук 
恩	おん	on	долг благодарности
温暖	おんだん	ondan	тепло
温度	おんど	ondo	температура
可	か	ka	возможный
課	か	ka	счетчик для глав (книги)
	カー	kaa	автомобиль
	カード	kaado	карта
会	かい	kai	встреча;ассоциация; клуб
回	かい	kai	счетное слово для раундов, состязаний
害	がい	gai	травма; вред; повреждение
会員	かいいん	kaiin	член собрания
絵画	かいが	kaiga	картинка
海外	かいがい	kaigai	иностранный
会計	かいけい	kaikei	счета, финансы, бухгалтерия
解決	かいけつ	kaiketsu	разгадка; разрешение
会合	かいごう	kaigou	встреча; сборка
外交	がいこう	gaikou	дипломатия
開始	かいし	kaishi	старт; начало 
解釈	かいしゃく	kaishaku	объяснение; интерпретация
外出	がいしゅつ	gaishutsu	выход из дома; прогулка
改善	かいぜん	kaizen	улучшение
快適	かいてき	kaiteki	приятный; комфортный
回復	かいふく	kaifuku	восстановление (после болезни); улучшение
飼う	かう	kau	держать (животное); кормить
替える	かえる	kaeru	менять; заменять 
換える	かえる	kaeru	менять; заменять
香り	かおり	kaori	аромат; запах
画家	がか	gaka	художник 
抱える	かかえる	kakaeru	держать (в охапке, на руках)
価格	かかく	kakaku	цена; значение; стоимость
化学	かがく	kagaku	химия
輝く	かがやく	kagayaku	сиять; блестеть; сверкать
係	かかり	kakari	должностное лицо; обязанность; ответственное лицо
掛かる	かかる	kakaru	принять (например время, деньги); вешать
罹る	かかる	kakaru	страдать от
鍵	かぎ	kagi	ключ
限る	かぎる	kagiru	ограничивать; ограничиться
描く	かく	kaku	рисовать; изображать 
家具	かぐ	kagu	мебель
学	がく	gaku	наука; знание
額	がく	gaku	лоб 
覚悟	かくご	kakugo	готовность; решимость
確実	かくじつ	kakujitsu	определенность; надежность; обоснованность
学者	がくしゃ	gakusha	ученый
学習	がくしゅう	gakushuu	обучение
隠す	かくす	kakusu	скрывать 
拡大	かくだい	kakudai	увеличение; расширение
確認	かくにん	kakunin	утверждение; подтверждение
学問	がくもん	gakumon	занятия; учение
隠れる	かくれる	kakureru	скрываться; быть скрытым
影	かげ	kage	тень 
陰	かげ	kage	тень; теневая сторона
欠ける	かける	kakeru	не хватать
加減	かげん	kagen	сложение и вычитание; учет
過去	かこ	kako	прошлое; предыдущий
籠	かご	kago	корзина; клетка
囲む	かこむ	kakomu	окружать; окружить
火災	かさい	kasai	пожар 
貸し	かし	kashi	кредит; заем
菓子	かし	kashi	кондитерские изделия
家事	かじ	kaji	домашняя работа
賢い	かしこい	kashikoi	мудрый; умный
歌手	かしゅ	kashu	певец
数	かず	kazu	число; фигура
稼ぐ	かせぐ	kasegu	получать доход; зарабатывать
数える	かぞえる	kazoeru	считать
型	かた	kata	модель; стиль; форма; тип
肩	かた	kata	плечо
硬い	かたい	katai	твёрдый; жёсткий
方々	かたがた	katagata	люди; тут и там, везде
刀	かたな	katana	меч; катана 
語る	かたる	kataru	говорить; рассказывать
勝ち	かち	kachi	выигрывать; побждать
価値	かち	kachi	цена
	がっかり	gakkari	чувствуете разочарование; быть удрученным 
活気	かっき	kakki	энергия; живость
学期	がっき	gakki	школьный семестр
格好	かっこう	kakkou	форма; осанка; пригодность
活動	かつどう	katsudou	действие; активность
活用	かつよう	katsuyou	практическое использование
悲しむ	かなしむ	kanashimu	грустить; оплакивать; жалеть
必ずしも	かならずしも	kanarazushimo	(не) всегда; (не) обязательно 
	かなり	kanari	значительно; довольно; довольно
金	かね	kane	золото; деньги
金持ち	かねもち	kanemochi	богач
可能	かのう	kanou	возможно
株	かぶ	kabu	доля; акция; пень 
被る	かぶる	kaburu	надевать на голову; брать вину на себя
構う	かまう	kamau	беспокоиться; обращать внимание
我慢	がまん	gaman	терпение; настойчивость
上	かみ	kami	первый том; высокое качество; верхний
神	かみ	kami	бог
雷	かみなり	kaminari	гром
髪の毛	かみのけ	kaminoke	волосы (на голове)
科目	かもく	kamoku	школьный предмет; учебная программа 
	かもしれない	kamoshirenai	может быть; возможно
火曜	かよう	kayou	(сокр) вторник
空	から	kara	небо
柄	がら	gara	рукоять (меча); рукоятка
刈る	かる	karu	подстричь (волосы); косить (траву) 
彼等	かれら	karera	они (обычно о мужчинах)
皮	かわ	kawa	кожи; шкура; кора; оболочка
革	かわ	kawa	кожа
	かわいそう	kawaisou	бедный; жалкий
	かわいらしい	kawairashii	прекрасный; милы
缶	かん	kan	консервная банка; бидон
勘	かん	kan	восприятие; интуиция, шестое чувство
考え	かんがえ	kangae	идея; намерение
感覚	かんかく	kankaku	смысл; ощущение
観客	かんきゃく	kankyaku	аудитория; зрители
環境	かんきょう	kankyou	окружающая среда
歓迎	かんげい	kangei	Добро пожаловать, прием
観光	かんこう	kankou	экскурсия
観察	かんさつ	kansatsu	наблюдение; опрос
感じ	かんじ	kanji	чувство; впечатление
感謝	かんしゃ	kansha	благодарность
患者	かんじゃ	kanja	пациент
勘定	かんじょう	kanjou	расчет; подсчет; рассмотрение
感情	かんじょう	kanjou	эмоции; чувство; настроение
感じる	かんじる	kanjiru	чувствовать; испытать
感心	かんしん	kanshin	восхищение 
関心	かんしん	kanshin	беспокойство; интерес
関する	かんする	kansuru	относиться, быть связанным с
完成	かんせい	kansei	завершение; совершенство; достижение
完全	かんぜん	kanzen	совершенство; полнота
感動	かんどう	kandou	быть глубоко тронутым; волнение; впечатление; глубокие эмоции
監督	かんとく	kantoku	надзор; контроль 
管理	かんり	kanri	контроль; управление 
完了	かんりょう	kanryou	завершение; вывод
関連	かんれん	kanren	отношение; соединение 
議員	ぎいん	giin	член парламента
記憶	きおく	kioku	память; воспоминание
気温	きおん	kion	температура
機械	きかい	kikai	машина; механизм
議会	ぎかい	gikai	конгресс; парламент
期間	きかん	kikan	период; срок
機関	きかん	kikan	механизм; двигатель
企業	きぎょう	kigyou	предприятие 
効く	きく	kiku	быть эффективным
機嫌	きげん	kigen	юмор; характер; настроение
気候	きこう	kikou	климат
岸	きし	kishi	побережье; берег
生地	きじ	kiji	место рождения
記事	きじ	kiji	статья; новость; отчет; счет
技師	ぎし	gishi	инженер; техник
記者	きしゃ	kisha	репортер
傷	きず	kizu	рана; травма
期待	きたい	kitai	ожидание; ожидание; надежда
帰宅	きたく	kitaku	возвращение домой
貴重	きちょう	kichou	драгоценный; ценный
議長	ぎちょう	gichou	председатель
	きちんと	kichinto	точно;
	きつい	kitsui	плотный; близкий; тесный
気付く	きづく	kizuku	замечать; признавать
気に入る	きにいる	kiniiru	быть довольным; прийтись по вкусу
記入	きにゅう	kinyuu	запись; заполнение форм
記念	きねん	kinen	празднование; память
機能	きのう	kinou	функция; способность
気の毒	きのどく	kinodoku	сожаление; жаль
寄付	きふ	kifu	вклад; пожертвование
希望	きぼう	kibou	надеюжда; желание
基本	きほん	kihon	фундамент; основа; стандарт
決まり	きまり	kimari	поселение; заключение; регулирование; правило
気味	きみ	kimi	чувство; ощущение
奇妙	きみょう	kimyou	странно; любопытно
義務	ぎむ	gimu	пошлина; обязательство, ответственность
疑問	ぎもん	gimon	вопрос; проблема; сомнения; думаю
逆	ぎゃく	gyaku	обратный
	キャプテン	kyaputen	капитан
	キャンプ	kyanpu	лагерь
九	きゅう	kyuu	девять
旧	きゅう	kyuu	экс-
級	きゅう	kyuu	класс; класс; звание; школьный класс, категория
球	きゅう	kyuu	сфера; мяч
休暇	きゅうか	kyuuka	праздник; выходной день; отпуск
休憩	きゅうけい	kyuukei	перерыв; передышка
急激	きゅうげき	kyuugeki	внезапно; обрывисто 
吸収	きゅうしゅう	kyuushuu	поглощение; всасывание
救助	きゅうじょ	kyuujo	помощь; спасение
急速	きゅうそく	kyuusoku	быстро (например прогрессировать)
急に	きゅうに	kyuuni	вдруг
給料	きゅうりょう	kyuuryou	заработная плата
器用	きよう	kiyou	удобный
教科書	きょうかしょ	kyoukasho	учебник
競技	きょうぎ	kyougi	игра; матч, конкурс
行儀	ぎょうぎ	gyougi	манеры
供給	きょうきゅう	kyoukyuu	питания; предоставление
教師	きょうし	kyoushi	учитель (класс)
教授	きょうじゅ	kyouju	преподавание; обучение; профессор
強調	きょうちょう	kyouchou	акцент; усиление
共通	きょうつう	kyoutsuu	общность; сообщество
共同	きょうどう	kyoudou	сотрудничество; ассоциация; сотрудничество; совместное
恐怖	きょうふ	kyoufu	страх; тревога 
協力	きょうりょく	kyouryoku	сотрудничество
強力	きょうりょく	kyouryoku	сила; мощь
許可	きょか	kyoka	разрешение; утверждение
局	きょく	kyoku	управление; бюро
巨大	きょだい	kyodai	огромный; гигантский
嫌う	きらう	kirau	ненавидеть;
霧	きり	kiri	туман
切れ	きれ	kire	кусок; ломоть
切れる	きれる	kireru	хорошо резать, быть острым; рваться; прерываться
	キロ	kiro	(сокр) кило-; килограмм; километр; 10 ^ 3
記録	きろく	kiroku	запись;
議論	ぎろん	giron	аргумент; обсуждение; спор
金	きん	kin	золото
銀	ぎん	gin	 серебро
禁煙	きんえん	kinen	курение запрещено
金額	きんがく	kingaku	сумма денег
金庫	きんこ	kinko	сейф; касса
禁止	きんし	kinshi	запрет;
金銭	きんせん	kinsen	деньги; наличные
金属	きんぞく	kinzoku	металл
近代	きんだい	kindai	текущий день
緊張	きんちょう	kinchou	напряженность; психическое напряжение; нервозность
筋肉	きんにく	kinniku	мышцы; сухожилия
金融	きんゆう	kinyuu	денежное обращение; кредитная ситуация
金曜	きんよう	kinyou	(сокр) пятница
九	く	ku	девять
句	く	ku	фраза
食う	くう	kuu	есть (грубый мужской вариант)
偶然	ぐうぜん	guuzen	случайно; неожиданно 
臭い	くさい	kusai	плохой запах; зловоние
鎖	くさり	kusari	цепь
腐る	くさる	kusaru	гнить 
癖	くせ	kuse	привычка (часто плохая); особенность
管	くだ	kuda	труба
具体	ぐたい	gutai	конкретность
下さる	くださる	kudasaru	(вежливо) давать 
下り	くだり	kudari	уезжать из Токио 
苦痛	くつう	kutsuu	боль; страдание
	ぐっすり	gussuri	крепко спать
区別	くべつ	kubetsu	различие; дифференциация; классификация
組	くみ	kumi	класс; группа; команда; набор
組合	くみあい	kumiai	ассоциация; союз
組む	くむ	kumu	собирать
曇	くもり	kumori	облачность; облако
位	くらい	kurai	класс; звание
暮らし	くらし	kurashi	проживание; средства к существовани
	クラシック	kurashikku	классический 
暮らす	くらす	kurasu	жить; ладить
	グラス	gurasu	стекло; трава
	グランド	gurando	великий 
	クリーム	kuriimu	крем
繰り返す	くりかえす	kurikaesu	повторять; делать что-то снова
	クリスマス	kurisumasu	рождество
狂う	くるう	kuruu	соходить с ума 
	グループ	guruupu	группа
苦しい	くるしい	kurushii	болезненный; мчительный
苦しむ	くるしむ	kurushimu	страдать; мучиться
暮れ	くれ	kure	конец года; закат; сумерки 
苦労	くろう	kurou	неприятности; трудности
加える	くわえる	kuwaeru	добавить; подводить итоги; добавлять
詳しい	くわしい	kuwashii	знать очень хорошо; подробный; точный
加わる	くわわる	kuwawaru	присоединять; увеличить; набирать (влияние)
訓	くん	kun	кунное чтение китайский символ
軍	ぐん	gun	армия; сила; войска
軍隊	ぐんたい	guntai	армия; войска
訓練	くんれん	kunren	практика, обучение
下	げ	ge	ниже; под
計	けい	kei	план
敬意	けいい	keii	уважение; честь
経営	けいえい	keiei	управление; администрация
計画	けいかく	keikaku	План; проект; график; схема; программа
景気	けいき	keiki	дела; положение дел
経験	けいけん	keiken	опыт
傾向	けいこう	keikou	тенденция; наклон
警告	けいこく	keikoku	предупреждение; совет
計算	けいさん	keisan	расчет; расплата
掲示	けいじ	keiji	уведомление; бюллетень
刑事	けいじ	keiji	уголовное дело; детектив
芸術	げいじゅつ	geijutsu	искусство
契約	けいやく	keiyaku	контракт; соглашение
経由	けいゆ	keiyu	идти по пути; через
	ケース	keesu	дело
	ゲーム	geemu	игра
怪我	けが	kega	травма 
劇	げき	geki	драма; игра
劇場	げきじょう	gekijou	театр;
化粧	けしょう	keshou	макияж 
	けち	kechi	скупость; скряга 
結果	けっか	kekka	результат; следствиее
欠陥	けっかん	kekkan	дефект; вина; дефицит
結局	けっきょく	kekkyoku	в конечном счете,
決心	けっしん	kesshin	определение; разрешение
欠席	けっせき	kesseki	отсутствие; непосещение
決定	けってい	kettei	решение, определение
欠点	けってん	ketten	неисправность; дефект; слабость
月曜	げつよう	getsuyou	понедельник
結論	けつろん	ketsuron	вывод
煙	けむり	kemuri	дым 
券	けん	ken	билет; купон; удостоверение
県	けん	ken	префектура
軒	けん	ken	карниз
喧嘩	けんか	kenka	ссора; драка 
見解	けんかい	kenkai	мнение; точка зрения
限界	げんかい	genkai	ограничивать 
現金	げんきん	genkin	наличные деньги 
言語	げんご	gengo	язык
健康	けんこう	kenkou	здоровье; полезный
検査	けんさ	kensa	осмотр, проверка (например завода); экспертиза
現在	げんざい	genzai	современность 
現実	げんじつ	genjitsu	реальность
現象	げんしょう	genshou	явление
現状	げんじょう	genjou	текущее состояние; существующее положение; статус-кво
建設	けんせつ	kensetsu	строительство; создание
現代	げんだい	gendai	в настоящее время; современность 
建築	けんちく	kenchiku	строительство; архитектура
見当	けんとう	kentou	найти; цель; оценка; думаю, около
検討	けんとう	kentou	рассмотрение, изучение, исследование
現場	げんば	genba	фактическое место;место преступления
憲法	けんぽう	kenpou	конституция
権利	けんり	kenri	сторон; привилегия
後	ご	go	потом, с тех пор, в будущем
語	ご	go	язык; слово
恋	こい	koi	любовь; страсть
濃い	こい	koi	густой (цвет); плотный (о веществе)
恋人	こいびと	koibito	любовник; любимый(ая)
幸運	こううん	kouun	удача 
講演	こうえん	kouen	лекция 
効果	こうか	kouka	эффект; эффективность; результат
硬貨	こうか	kouka	монета
高価	こうか	kouka	высокая цена
豪華	ごうか	gouka	великолепие; пышность 
合格	ごうかく	goukaku	успешное прохождения (например экзамена); соответствие требованиям
交換	こうかん	koukan	обмен; взаимность
航空	こうくう	koukuu	авиация; летать
光景	こうけい	koukei	сцена 
合計	ごうけい	goukei	общая сумма
攻撃	こうげき	kougeki	атака; забастовка; наступление; порицание
貢献	こうけん	kouken	вклад; услуги
広告	こうこく	koukoku	реклама
交際	こうさい	kousai	компания; дружба; ассоциация; общество; знакомство
後者	こうしゃ	kousha	последний
工場	こうば	kouba	завод; мастерская
構成	こうせい	kousei	организация; состав
高速	こうそく	kousoku	высокая скорость
行動	こうどう	koudou	действие; поведение 
強盗	ごうとう	goutou	грабеж; взлом
幸福	こうふく	koufuku	счастье 
公平	こうへい	kouhei	справедливость; беспристрастность
候補	こうほ	kouho	кандидатура
考慮	こうりょ	kouryo	рассмотрение; учето
越える	こえる	koeru	превышать; пересекать;
	コーチ	koochi	тренер
	コード	koodo	код 
氷	こおり	koori	лед 
凍る	こおる	kooru	замораживать; застывать
	ゴール	gooru	цель
誤解	ごかい	gokai	недоразумение
語学	ごがく	gogaku	изучение языков
呼吸	こきゅう	kokyuu	дыхание; дыхание
故郷	こきょう	kokyou	родной город; родина 
極	ごく	goku	очень
国語	こくご	kokugo	национальный язык
黒板	こくばん	kokuban	классная доска
克服	こくふく	kokufuku	подчинение; завоевание
国民	こくみん	kokumin	национальность; люди
穀物	こくもつ	kokumotsu	зерна; зерновые
ここ	ここ	koko	здесь
腰	こし	koshi	бедро
故障	こしょう	koshou	авария; выход из строя
個人	こじん	kojin	личность; частное лицо; личный 
越す	こす	kosu	переходить
国家	こっか	kokka	государство; страна; нация
国会	こっかい	kokkai	парламент; конгресс
国境	こっきょう	kokkyou	государственная граница
骨折	こっせつ	kossetsu	перелом кости
小包	こづつみ	kozutsumi	посылка
事	こと	koto	вещь; дело; факт; обстоятельства
異なる	ことなる	kotonaru	отличаться; варьироватьcz
諺	ことわざ	kotowaza	пословица 
断る	ことわる	kotowaru	отказаться; снижаться; уволять
粉	こな	kona	мука;порошок
この	この	kono	это
好み	このみ	konomi	симпатия; вкус; выбор
好む	このむ	konomu	нравиться; предпочитать
	コピー	kopii	копия 
塵	ごみ	gomi	пыль; грязь
小麦	こむぎ	komugi	пшеница
	ごめんなさい	gomennasai	прошу прощения; извините
小屋	こや	koya	кабина; конура для животного
	これら	korera	эти
頃	ころ	koro	Время, около; к; примерно (время)
殺す	ころす	korosu	убивать
転ぶ	ころぶ	korobu	падать; скатываться
今回	こんかい	konkai	теперь; на этот раз 
今後	こんご	kongo	отныне; далее
混雑	こんざつ	konzatsu	путаница; хаос
	こんなに	konnani	так, как это, в этом случае
困難	こんなん	konnan	Трудности; бедствия
今日	こんにち	konnichi	сегодня; этот день
	コンピューター	konpyuutaa	компьютер
婚約	こんやく	konyaku	помолвка
混乱	こんらん	konran	хаос; путаница; беспорядок
差	さ	sa	разница; изменение
	サービス	saabisu	обслуживание; система поддержки
際	さい	sai	по случаю; по обстоятельствам
最高	さいこう	saikou	самый высокий; наиболее
財産	ざいさん	zaisan	собственность; активы
最終	さいしゅう	saishuu	самый последний
最中	さいちゅう	saichuu	в середине
最低	さいてい	saitei	самый низкий; худший
才能	さいのう	sainou	талант, способность
裁判	さいばん	saiban	суд
材料	ざいりょう	zairyou	ингредиенты, материалы
幸い	さいわい	saiwai	счастье; блаженство
	サイン	sain	автограф; знак 
境	さかい	sakai	граница; предел
逆らう	さからう	sakarau	идти против; противостоять; ослушаться; бросить вызов
盛り	さかり	sakari	расцвет; разгар
作業	さぎょう	sagyou	работа; производство 
昨	さく	saku	прошлый
作品	さくひん	sakuhin	результат производства; товары
作物	さくもつ	sakumotsu	производить (например сельскохозяйственное); культуры
桜	さくら	sakura	вишня
酒	さけ	sake	алкоголь; саке
叫ぶ	さけぶ	sakebu	кричать; плакать
避ける	さける	sakeru	избегать; предотвращать
支える	ささえる	sasaeru	поддерживать; подпирать
指す	さす	sasu	указывать
座席	ざせき	zaseki	сиденье
誘う	さそう	sasou	приглашать; спрашивать; зазывать
札	さつ	satsu	этикетка; билет; купюра
作家	さっか	sakka	автор, писатель; художник
作曲	さっきょく	sakkyoku	сочинение (музыки)
	ざっと	zatto	примерно, в круглых цифрах
	さっぱり	sappari	чувство обновления; чувствуя облегчение
	さて	sate	хорошо, а теперь;, после чего
砂漠	さばく	sabaku	пустыня
差別	さべつ	sabetsu	дискриминация; различие; дифференциация
作法	さほう	sahou	манеры; этикет; приличия
様々	さまざま	samazama	разнообразные; различные
覚ます	さます	samasu	будить
覚める	さめる	sameru	чтобы разбудить; проснуться
左右	さゆう	sayuu	слева и справа; влияние, контроль 
皿	さら	sara	тарелка; блюдо
更に	さらに	sarani	кроме того; и снова, в конце концов; все больше и больше
去る	さる	saru	оставлять; уходить
猿	さる	saru	обезьяна
騒ぎ	さわぎ	sawagi	шум 
参加	さんか	sanka	участие
参考	さんこう	sankou	ссылка; консультация
賛成	さんせい	sansei	утверждение; соглашение; поддержка
酸素	さんそ	sanso	кислород
散歩	さんぽ	sanpo	прогулка
氏	し	shi	фамилия; линия; рождения
詩	し	shi	Стихотворение; стих поэзии
幸せ	しあわせ	shiawase	счастье; удача; удача; благословение
	ジーンズ	jiinzu	джинсы
ジェット機	ジェットき	jettoki	реактивный самолет
直に	じかに	jikani	немедленно; легко; непосредственно
	しかも	shikamo	кроме того, кроме того, тем не менее, и в то же
叱る	しかる	shikaru	ругать
式	しき	shiki	уравнение; формула; церемония
直	じき	jiki	искренне; сразу; точно
時期	じき	jiki	время; сезон; период
支給	しきゅう	shikyuu	оплата; пособие
	しきりに	shikirini	часто; неоднократно; постоянно; нетерпением
刺激	しげき	shigeki	стимул; импульс; стимулом
資源	しげん	shigen	ресурсы
事件	じけん	jiken	события; дело; инцидент
時刻	じこく	jikoku	мгновенный; время; момент
自殺	じさつ	jisatsu	самоубийство
事実	じじつ	jijitsu	правда; реальность
支出	ししゅつ	shishutsu	расходов; расходы
事情	じじょう	jijou	обстоятельства; условия; ситуация; причины
詩人	しじん	shijin	поэт
自身	じしん	jishin	по себе; лично
沈む	しずむ	shizumu	тонуть; чувствовать себя подавленным
自然	しぜん	shizen	природа; естественный
思想	しそう	shisou	мысль; идея
舌	した	shita	язык
次第	しだい	shidai	порядок; побстоятельства 
事態	じたい	jitai	ситуация; нынешнее состояние дел
従う	したがう	shitagau	соблюдать (правила); подчиняться; следовать; сопровождать
したがって	したがって	shitagatte	поэтому, следовательно, в соответствии с
支度	したく	shitaku	подготовка
親しい	したしい	shitashii	близкий; дружеский
質	しつ	shitsu	качество, природа (человека)
失業	しつぎょう	shitsugyou	безработица
実験	じっけん	jikken	эксперимент
実現	じつげん	jitsugen	реализация; материализация; реализация
実行	じっこう	jikkou	реализация; практика; производительность; выполнение (например, программа)
実際	じっさい	jissai	фактическое состояние; статус-кво
実施	じっし	jisshi	проведение в жизнь; осуществление
	じっと	jitto	жестко; твердо; терпеливо; спокойно
実に	じつに	jitsuni	действительно, по-настоящему; безусловно
実は	じつは	jitsuha	как по сути; кстати
失望	しつぼう	shitsubou	разочарование; отчаяние
支店	してん	shiten	филиал 
指導	しどう	shidou	лидерство; руководство 
自動	じどう	jidou	автоматический 
品	しな	shina	вещь; качество; товар 
支配	しはい	shihai	правило, контроль; направление
芝居	しばい	shibai	спектакль
	しばしば	shibashiba	часто; снова и снова 
芝生	しばふ	shibafu	газон
支払	しはらい	shiharai	оплата
支払う	しはらう	shiharau	платить
死亡	しぼう	shibou	смерть; смертность
資本	しほん	shihon	фонды, капитал
姉妹	しまい	shimai	сестры
	しまう	shimau	заканчивать; полностью сделать что-то
	しまった	shimatta	Черт побери!
自慢	じまん	jiman	гордость; хвастовство
事務	じむ	jimu	бизнес; работа в офисе
示す	しめす	shimesu	для обозначения; показать, указать; чтобы указать
占める	しめる	shimeru	занимать (место, положение, позиции и т.п.)
下	しも	shimo	под, ниже; под
霜	しも	shimo	мороз
	じゃあ	jaa	хорошо, ну а затем
借金	しゃっきん	shakkin	долг; кредит
	しゃべる	shaberu	общаться; болтать
邪魔	じゃま	jama	помеха; неудобство
週	しゅう	shuu	неделя
州	しゅう	shuu	отмель
十	じゅう	juu	10; десять
銃	じゅう	juu	пистолет
周囲	しゅうい	shuui	окрестности; окружность 
収穫	しゅうかく	shuukaku	сбор урожая
週間	しゅうかん	shuukan	 еженедельный
宗教	しゅうきょう	shuukyou	религия
重視	じゅうし	juushi	важность; внимание
就職	しゅうしょく	shuushoku	трудоустройство
	ジュース	juusu	сок
修正	しゅうせい	shuusei	поправка; коррекция; пересмотр; модификация
渋滞	じゅうたい	juutai	пробка (трафика); задержка; застой
重大	じゅうだい	juudai	серьезный; важный; весомый
住宅	じゅうたく	juutaku	дом; жилье
集団	しゅうだん	shuudan	группа 
集中	しゅうちゅう	shuuchuu	концентрация;
収入	しゅうにゅう	shuunyuu	доход; поступления 
住民	じゅうみん	juumin	граждане; жители; население
重要	じゅうよう	juuyou	важный; знаменательный; важно 
修理	しゅうり	shuuri	ремонт 
主義	しゅぎ	shugi	доктрина; правило; принцип
宿泊	しゅくはく	shukuhaku	жилье
手術	しゅじゅつ	shujutsu	хирургическая операция
首相	しゅしょう	shushou	премьер-министр
手段	しゅだん	shudan	средство; способ; мера
主張	しゅちょう	shuchou	претензии; запрос; настойчивость; утверждение
出身	しゅっしん	shusshin	выпускник; родом из
出席	しゅっせき	shusseki	посещаемость; присутствие
出発	しゅっぱつ	shuppatsu	отправление
出版	しゅっぱん	shuppan	публикация
首都	しゅと	shuto	столица
主婦	しゅふ	shufu	домохозяйка; хозяйка
主要	しゅよう	shuyou	главный; основной; основной; основным
需要	じゅよう	juyou	спрос; запрос
種類	しゅるい	shurui	Разнообразие; вид; Тип
順	じゅん	jun	порядок; очередь
瞬間	しゅんかん	shunkan	момент 
順調	じゅんちょう	junchou	благоприятный
順番	じゅんばん	junban	порядок вещей
準備	じゅんび	junbi	подготовка; договоренность 
使用	しよう	shiyou	использование
小	しょう	shou	небольшой
章	しょう	shou	глава книги; значок, эмблема
賞	しょう	shou	премия; награда
障害	しょうがい	shougai	препятствием; препятствием (ошибка); повреждения
奨学金	しょうがくきん	shougakukin	стипендия
乗客	じょうきゃく	joukyaku	пассажир
上京	じょうきょう	joukyou	прибыть в Токио 
状況	じょうきょう	joukyou	состояние дел; ситуация; обстоятельства
条件	じょうけん	jouken	условия; термины
正午	しょうご	shougo	полдень; середина дня
正直	しょうじき	shoujiki	честность; откровенность
常識	じょうしき	joushiki	здравый смысл
少女	しょうじょ	shoujo	дочь; девочка; девушка
少々	しょうしょう	shoushou	всего минуту; небольшое количество
症状	しょうじょう	shoujou	симптомы; состояние
生じる	しょうじる	shoujiru	производить; возникнать
招待	しょうたい	shoutai	приглашение
状態	じょうたい	joutai	состояние; ситуация; обстоятельства 
上達	じょうたつ	joutatsu	улучшение; продвижение; прогресс
冗談	じょうだん	joudan	шутка
承知	しょうち	shouchi	согласие, принятие 
上等	じょうとう	joutou	превосходство; первый класс 
衝突	しょうとつ	shoutotsu	столкновения; конфликт
商人	しょうにん	shounin	трейдер; продавец
承認	しょうにん	shounin	признание; утверждение; согласие 
少年	しょうねん	shounen	юноша; несовершеннолетний
商売	しょうばい	shoubai	торговля; бизнес; коммерция 
消費	しょうひ	shouhi	потребление; расходы
商品	しょうひん	shouhin	товар; предмет торговли
消防	しょうぼう	shoubou	пожаротушение; пожарная
情報	じょうほう	jouhou	информация 
証明	しょうめい	shoumei	доказательство; проверка
女王	じょおう	joou	королева
職	しょく	shoku	занятость
職業	しょくぎょう	shokugyou	оккупация; бизнес
食事	しょくじ	shokuji	еда
食卓	しょくたく	shokutaku	обеденный стол
食品	しょくひん	shokuhin	товар; продукты питания
植物	しょくぶつ	shokubutsu	растений; растительность
食物	しょくもつ	shokumotsu	питание; продукты питания
食欲	しょくよく	shokuyoku	аппетит
食料	しょくりょう	shokuryou	еда
食糧	しょくりょう	shokuryou	положений; рационы
書斎	しょさい	shosai	исследование
女子	じょし	joshi	женщина; девушка
助手	じょしゅ	joshu	помощник
徐々に	じょじょに	jojoni	медленно; мало-помалу; постепенно; неуклонно; спокойно
署名	しょめい	shomei	подпись
書物	しょもつ	shomotsu	книги
女優	じょゆう	joyuu	актриса
処理	しょり	shori	обработка; управление
書類	しょるい	shorui	документы 
知らせ	しらせ	shirase	уведомление
尻	しり	shiri	зад; хвост
印	しるし	shirushi	знак; символ
城	しろ	shiro	замок
進学	しんがく	shingaku	поступление в учебное заведение более высокой ступени
神経	しんけい	shinkei	нерв; чувствительность
真剣	しんけん	shinken	серьезность
信仰	しんこう	shinkou	(религиозная) вера 
信号	しんごう	shingou	светофор; сигнал; знак;
人工	じんこう	jinkou	искусственный; человеческий труд 
深刻	しんこく	shinkoku	серьезный
診察	しんさつ	shinsatsu	медицинский осмотр
人種	じんしゅ	jinshu	раса
信じる	しんじる	shinjiru	верить 
人生	じんせい	jinsei	человеческая жизнь
親戚	しんせき	shinseki	относительный
新鮮	しんせん	shinsen	свежий
心臓	しんぞう	shinzou	сердце
身体	しんたい	shintai	тело
身長	しんちょう	shinchou	рост (тела)
慎重	しんちょう	shinchou	усмотрение; благоразумие
心配	しんぱい	shinpai	волнение; озабоченность; беспокойство
審判	しんぱん	shinpan	судейство; процесс; суждение; судья 
人物	じんぶつ	jinbutsu	характер; личность; персонаж; 
進歩	しんぽ	shinpo	прогресс, развитие
親友	しんゆう	shinyuu	близкий друг 
信用	しんよう	shinyou	уверенность; вера
信頼	しんらい	shinrai	доверие; уверенность
心理	しんり	shinri	психология
人類	じんるい	jinrui	человечество
巣	す	su	гнездо; улей; паутина
図	ず	zu	рисунок; иллюстрация
水準	すいじゅん	suijun	уровень воды; стандарт
推薦	すいせん	suisen	рекомендация
	スイッチ	suicchi	переключатель
随分	ずいぶん	zuibun	чрезвычайно
睡眠	すいみん	suimin	сон
数	すう	suu	число; фигура
数字	すうじ	suuji	цифра; фигура
	スープ	suupu	суп
末	すえ	sue	окончание
姿	すがた	sugata	фигура; форма
	スキー	sukii	катание на лыжах
空く	すく	suku	открывать; становиться пустым
救う	すくう	sukuu	спасать
優れる	すぐれる	sugureru	превосходить
	スケート	sukeeto	катание
	すごい	sugoi	ужасно; потрясающе; удивительно
少しも	すこしも	sukoshimo	что-нибудь 
過ごす	すごす	sugosu	проходить; преодолевать
筋	すじ	suji	мышцы; строка; линия
進める	すすめる	susumeru	продвигаться; прогрессировать
勧める	すすめる	susumeru	рекомендовать; советовать; поощрять 
	スター	sutaa	звезда
	スタイル	sutairu	стиль
	スタンド	sutando	стоять
頭痛	ずつう	zutsuu	головная боль
	ずっと	zutto	всегда; прямо; всё время; сплошь
	すてき	suteki	прекрасный; удивительный
既に	すでに	sudeni	уже 
	すなわち	sunawachi	то есть, а именно 
素晴らしい	すばらしい	subarashii	замечательно; великолепный; великолепный
	スピーチ	supiichi	речь
全て	すべて	subete	все; полностью 
済ませる	すませる	sumaseru	завершать
角	すみ	sumi	внутренний угол;
為る	する	suru	делать
すると	すると	suruto	вслед за этим; вследствие этого
鋭い	するどい	surudoi	резкий; острый
背	せい	sei	высота; рост
正	せい	sei	верный; правильный
生	せい	sei	необработанный; живой
性	せい	sei	пол
所為	せい	sei	причина; вина; из-за
税	ぜい	zei	налог
性格	せいかく	seikaku	характер; личность
正確	せいかく	seikaku	точный; пунктуальный
世紀	せいき	seiki	век; эпоха
請求	せいきゅう	seikyuu	спрос; заявление; запрос
税金	ぜいきん	zeikin	налог; долг
清潔	せいけつ	seiketsu	чистый
制限	せいげん	seigen	ограничение; сдержанность; ограничение
成功	せいこう	seikou	успех 
生産	せいさん	seisan	производство 
正式	せいしき	seishiki	форма; официальный; формальность
精神	せいしん	seishin	ум; душа; дух;
成人	せいじん	seijin	взрослый; совершеннолетний
精々	せいぜい	seizei	самое большее, в лучшем случае; до предела; насколько это возможно
成績	せいせき	seiseki	результаты; запись
製造	せいぞう	seizou	производство 
贅沢	ぜいたく	zeitaku	роскошь; расточительность
成長	せいちょう	seichou	рост 
制度	せいど	seido	учреждение, организация
青年	せいねん	seinen	молодежь; молодой человек
製品	せいひん	seihin	промышленные товары; готовая продукция
政府	せいふ	seifu	правительство; администрация
生物	せいぶつ	seibutsu	сырая пища
生命	せいめい	seimei	жизнь; существование
整理	せいり	seiri	сортировка; расположение; регулирование
咳	せき	seki	кашель
石炭	せきたん	sekitan	уголь
責任	せきにん	sekinin	обязанность; ответственность
石油	せきゆ	sekiyu	масло; нефтяной; керосин
世間	せけん	seken	мир; общество
説	せつ	setsu	теория
積極的	せっきょくてき	sekkyokuteki	положительный; активный
設計	せっけい	sekkei	план, дизайн
絶対	ぜったい	zettai	абсолютный; безусловный
	セット	setto	набор
設備	せつび	setsubi	оборудование; устройство; объекты; установка
絶滅	ぜつめつ	zetsumetsu	уничтожение; вымирание
節約	せつやく	setsuyaku	экономия 
是非	ぜひ	zehi	конечно; обязательно
責める	せめる	semeru	судить; критиковать
世話	せわ	sewa	уход; помочь;
善	ぜん	zen	благость; право; добродетель
全	ぜん	zen	все; полная, в целом 
全員	ぜんいん	zenin	все члены все руки; полностью
専攻	せんこう	senkou	специализация
全国	ぜんこく	zenkoku	общенациональный
先日	せんじつ	senjitsu	на днях; несколько дней назад
前者	ぜんしゃ	zensha	бывший
選手	せんしゅ	senshu	игрок; команда
前進	ぜんしん	zenshin	продвижение; прогресс
全然	ぜんぜん	zenzen	полностью 
	センター	sentaa	центр
全体	ぜんたい	zentai	полнота; все 
選択	せんたく	sentaku	отбор; выбор
そう	そう	sou	так
象	ぞう	zou	слон
騒音	そうおん	souon	шум
増加	ぞうか	zouka	увеличиение; дополнение
操作	そうさ	sousa	операция; управление; обработка
掃除	そうじ	souji	очистка; подметание
想像	そうぞう	souzou	воображение; догадка
相続	そうぞく	souzoku	преемственность; наследование
相談	そうだん	soudan	консультации; обсуждение
装置	そうち	souchi	оборудование, монтаж; аппарат
相当	そうとう	soutou	справедливо; терпимо 
速度	そくど	sokudo	скорость 
底	そこ	soko	пол; дно
	そこで	sokode	соответственно; в этой связи
組織	そしき	soshiki	организация; строительство; ткань; система
	そして	soshite	и
注ぐ	そそぐ	sosogu	наливать; для орошать;лить; проливать
育つ	そだつ	sodatsu	поднимать (ребенка); на воспитание; расти (до)
	そっくり	sokkuri	все; вообще; полностью; быть точно так же как 
	そっと	sotto	поверхность земли
袖	そで	sode	рукав
備える	そなえる	sonaeru	оборудовать; устанавливать
	そのうち	sonouchi	в конце концов, рано или поздно, из ранее упомянутых
	そのまま	sonomama	без изменений; как сейчас
側	そば	soba	сторона; край; рядом
	ソファー	sofaa	диван; софа
粗末	そまつ	somatsu	простой; грубый;бедный
	それぞれ	sorezore	каждый; порознь
	それでも	soredemo	и все же; тем не менее, даже в этом случае; несмотря на
	それと	soreto	к тому же
	それとも	soretomo	или 
損	そん	son	gотеря; недостаток
損害	そんがい	songai	повреждение; травма
尊敬	そんけい	sonkei	уважение; достоинство; честь
存在	そんざい	sonzai	существование 
尊重	そんちょう	sonchou	уважение; достоинство
田	た	ta	рисовое поле
他	た	ta	другие (места и вещи)
対	たい	tai	пара;набор
台	だい	dai	подставка; стеллаж; трибуна
題	だい	dai	название; предмет; тема 
体育	たいいく	taiiku	гимнастика; легкая атлетика
体温	たいおん	taion	температура 
大会	たいかい	taikai	конвенция;митинг
大気	たいき	taiki	атмосфера
代金	だいきん	daikin	цена; оплата, стоимость; заряд
退屈	たいくつ	taikutsu	скука 
滞在	たいざい	taizai	остановка где-либо; пребывание
大使	たいし	taishi	посол
大した	たいした	taishita	Значительный; великий; важно;
対象	たいしょう	taishou	целевой объект; субъект налогообложения
大臣	だいじん	daijin	член совета министров
対する	たいする	taisuru	противостоять
大戦	たいせん	taisen	Великая война; великая битва
大抵	たいてい	taitei	обычно; как правило,
態度	たいど	taido	отношение; манера
大統領	だいとうりょう	daitouryou	президент; главный исполнительный
大半	たいはん	taihan	в основном, как правило,
代表	だいひょう	daihyou	представитель; делегация; пример; модель
大部分	だいぶぶん	daibubun	большинство
	タイプライター	taipuraitaa	пишущая машинка
大変	たいへん	taihen	ужасно; очень
逮捕	たいほ	taiho	арест; захват
	ダイヤ	daiya	схема; график
太陽	たいよう	taiyou	солнце 
平ら	たいら	taira	плоскость; уровень; гладкий;равнина
代理	だいり	dairi	представительство; агентство; заместитель; агент
大陸	たいりく	tairiku	континент
倒す	たおす	taosu	бросить; сбить 
	タオル	taoru	полотенце
だが	だが	daga	но
互い	たがい	tagai	взаимный; обратный
宝	たから	takara	сокровище
だから	だから	dakara	так, поэтому
宅	たく	taku	дом 
	だけど	dakedo	однако
確かめる	たしかめる	tashikameru	выяснять
多少	たしょう	tashou	более или менее; несколько; немного; некоторые
助ける	たすける	tasukeru	помгать; сохранять; спасать
唯	ただ	tada	 лишь; только 
戦い	たたかい	tatakai	битва; борьба; конфликт
戦う	たたかう	tatakau	бороться 
叩く	たたく	tataku	хлопать; бить
直ちに	ただちに	tadachini	сразу; немедленно; непосредственно 
立ち上がる	たちあがる	tachiagaru	вставать
立場	たちば	tachiba	точка зрения; положение; ситуация
経つ	たつ	tatsu	проходить (о времени)
達する	たっする	tassuru	достигать; добираться до
唯	たった	tatta	лишь; только 
	だって	datte	но; потому что
	たっぷり	tappuri	полном объеме; достаточно
縦	たて	tate	ширина; длина
	たとえ	tatoe	сравнение; пример
谷	たに	tani	долина
他人	たにん	tanin	другой человек; незнакомец
種	たね	tane	семя; материал; причина; источник
束	たば	taba	связка; пучок
度	たび	tabi	кол-во раз
旅	たび	tabi	путешествия; поездка 
	たびたび	tabitabi	часто; неоднократно
多分	たぶん	tabun	возможно; вероятно
玉	たま	tama	мяч; сфера; монета
球	たま	tama	сфера; мяч
弾	たま	tama	пуля 
偶	たま	tama	четное число; пара; муж и жена 
偶々	たまたま	tamatama	случайно; неожиданно 
	たまらない	tamaranai	невыносимо
黙る	だまる	damaru	молчать
駄目	だめ	dame	бесполезно; ничего хорошего; нельзя
試し	ためし	tameshi	процесс; тест
試す	ためす	tamesu	пытаться; тестироваться
便り	たより	tayori	новость; весть; информация, переписка; письмо
頼る	たよる	tayoru	полагаться на; прибегнуть к; зависеть от
誰か	だれか	dareka	кто-то 
段	だん	dan	шаг; лестница; лестничный пролет; класс; звание; уровень
単位	たんい	tani	Блок; номинал; семестр (в школе)
単語	たんご	tango	(как правило) односимвольное слово
男子	だんし	danshi	молодежь; молодой человек
単純	たんじゅん	tanjun	простота
誕生	たんじょう	tanjou	рождение
	ダンス	dansu	танец
団体	だんたい	dantai	организация; объединение
担当	たんとう	tantou	исполнение обязанностей
単なる	たんなる	tannaru	просто 
単に	たんに	tanni	просто; только 
地	ち	chi	земля
地位	ちい	chii	(социальное) положение; статус
地域	ちいき	chiiki	площадь; область
	チーズ	chiizu	сыр
	チーム	chiimu	команда
知恵	ちえ	chie	мудрость; остроумие; прозорливость; смысл; интеллект 
地下	ちか	chika	подвал; подземный
違い	ちがい	chigai	разница; несоответствие
違いない	ちがいない	chigainai	точно; без сомнения
近頃	ちかごろ	chikagoro	в последнее время; недавно 
地球	ちきゅう	chikyuu	земля
地区	ちく	chiku	район; раздел; сектор
遅刻	ちこく	chikoku	опоздание 
知事	ちじ	chiji	губернатор префектуры
知識	ちしき	chishiki	знание; информация
父親	ちちおや	chichioya	отец
知能	ちのう	chinou	способность; ум
地平線	ちへいせん	chiheisen	горизонт
地方	ちほう	chihou	площадь; местность; район; область; побережье
茶	ちゃ	cha	чай
	チャンス	chansu	шанс; возможность
	ちゃんと	chanto	прекрасно; должным образом; точно
中	ちゅう	chuu	внутри; середина; среди
注	ちゅう	chuu	комментарий; примечание
中央	ちゅうおう	chuuou	центр 
中学	ちゅうがく	chuugaku	средняя школа 
中古	ちゅうこ	chuuko	бывшего употребления
中止	ちゅうし	chuushi	 остановка; прекращение; прерывание
駐車	ちゅうしゃ	chuusha	парковка 
昼食	ちゅうしょく	chuushoku	обед
中心	ちゅうしん	chuushin	центр; ядро; сердце; стержень; баланс
注目	ちゅうもく	chuumoku	уведомление; внимание; наблюдение
注文	ちゅうもん	chuumon	запрос
長期	ちょうき	chouki	долгое время
調査	ちょうさ	chousa	расследование; экспертиза; запрос; опрос
調子	ちょうし	choushi	мелодия; тон; ключ
頂上	ちょうじょう	choujou	вершина; пик
	ちょうだい	choudai	пожалуйста, сделать для меня (предшествует форме на て); прием 
貯金	ちょきん	chokin	экономия
直接	ちょくせつ	chokusetsu	прямой; немедленно; персональный 
著者	ちょしゃ	chosha	автор, писатель
遂に	ついに	tsuini	в конце концов
通過	つうか	tsuuka	прохождение через; мимоходом
通学	つうがく	tsuugaku	посещение школы
通行	つうこう	tsuukou	проход; прохождение
通じる	つうじる	tsuujiru	вести;доходить до; быть проложенным
通信	つうしん	tsuushin	связь; сигнал
捕まる	つかまる	tsukamaru	быть пойманным; быть арестованным
掴む	つかむ	tsukamu	захватить; поймать 
疲れ	つかれ	tsukare	усталость 
月	つき	tsuki	луна; месяц
付き合い	つきあい	tsukiai	знакомство; общение
次々	つぎつぎ	tsugitsugi	последовательно, один за другим
就く	つく	tsuku	поступать (на должность; приступать
注ぐ	つぐ	tsugu	лить; наливать
付ける	つける	tsukeru	приложить; присоединить; добавить 
土	つち	tsuchi	земля; почва
続き	つづき	tsuzuki	продолжение
包み	つつみ	tsutsumi	свёрток; пакет; обёртка
勤め/務め	つとめ	tsutome	обслуживание; обязанность;ответственность; буддийские религиозные службы
繋ぐ	つなぐ	tsunagu	связывать;подключать; передавать (телефонный звонок)
常に	つねに	tsuneni	всегда; постоянно
翼	つばさ	tsubasa	крылья
	つまり	tsumari	короче говоря; в двух словах; другими словами
罪	つみ	tsumi	преступление; вина 
詰める	つめる	tsumeru	упаковывать; сокращать 
積もる	つもる	tsumoru	накапливаться
梅雨	つゆ	tsuyu	сезон дождей 
辛い	つらい	tsurai	тяжёлый; горький
釣	つり	tsuri	рыбалка
連れ	つれ	tsure	компаньон; компания
出会い	であい	deai	встреча
出会う	であう	deau	встретиться (обычно случайно)
提案	ていあん	teian	предложение
定期	ていき	teiki	фиксированный срок
抵抗	ていこう	teikou	электрическое сопротивление; сопротивление; оппозиция
提出	ていしゅつ	teishutsu	предъявление; представление; 
程度	ていど	teido	степень; мера; уровень; пределы
停留所	ていりゅうじょ	teiryuujo	автобусная или трамвайная остановка
	デート	deeto	дата; свидание
敵	てき	teki	враг; сопернико
出来事	できごと	dekigoto	инцидент; дело; событие
適する	てきする	tekisuru	соответствовать; удовлетворять (требованиям)
適切	てきせつ	tekisetsu	уместно; необходимо; адекватно; актуально
適度	てきど	tekido	умеренность
適用	てきよう	tekiyou	применение
出来るだけ	できるだけ	dekirudake	насколько возможно
	できれば	dekireba	если это возможно
手品	てじな	tejina	ловкость рук; уловка; жонглирование
	ですから	desukara	поэтому
鉄	てつ	tetsu	железо
哲学	てつがく	tetsugaku	философия
手伝い	てつだい	tetsudai	помощь; помощник, ассистент
徹底	てってい	tettei	тщательность; полнота
鉄道	てつどう	tetsudou	железная дорога
徹夜	てつや	tetsuya	вся ночь; бессонная ночь
では	では	deha	возможность выйти откуда-л.
手間	てま	tema	время; труд
でも	でも	demo	но, однако
	デモ	demo	демонстрация
典型	てんけい	tenkei	классическая форма; образец; типовой экземпляр
天候	てんこう	tenkou	погода
電子	でんし	denshi	электрон
	テント	tento	палатка
伝統	でんとう	dentou	традиция
天然	てんねん	tennen	природа; естественность
度	ど	do	счетчик для вхождений
問い	とい	toi	вопрос; запрос
党	とう	tou	партия (политическая)
塔	とう	tou	башня; пагода
	どう	dou	ребенок 
答案	とうあん	touan	экзаменационная работа 
同一	どういつ	douitsu	идентичность; сходство
	どうか	douka	медная монета
当時	とうじ	touji	в то время, в те дни
動詞	どうし	doushi	глагол
同時	どうじ	douji	одновременно; то же время; синхронно
	どうしても	doushitemo	всеми средствами; любой ценой; независимо от того, что
到着	とうちゃく	touchaku	прибытие
道徳	どうとく	doutoku	нравы
投票	とうひょう	touhyou	голосование; опрос
同様	どうよう	douyou	такой же; похожий
同僚	どうりょう	douryou	сотрудник; коллега 
道路	どうろ	douro	дорога; шоссе
十	とお	too	десять
通す	とおす	toosu	пропускать; не заметить; продолжать
通り	とおり	toori	в соответствии с ч-л; следующее ~; улица 
通り過ぎる	とおりすぎる	toorisugiru	проходить через
都会	とかい	tokai	город
時	とき	toki	время; час; момент
解く	とく	toku	развязывать; распускать
毒	どく	doku	яд
得意	とくい	tokui	гордость; триумф; процветание
読書	どくしょ	dokusho	чтение
独身	どくしん	dokushin	холостой; одинарный; одинокий
特徴	とくちょう	tokuchou	функция; характеристика
独特	どくとく	dokutoku	особенность; уникальность; характеристика
独立	どくりつ	dokuritsu	независимость
解ける	とける	tokeru	быть развязанным, распутанным
	どこか	dokoka	где-то 
	ところが	tokoroga	однако, в то время, даже если
	ところで	tokorode	кстати; даже если; независимо от того, что
登山	とざん	tozan	альпинизм
都市	とし	toshi	город 
年月	としつき	toshitsuki	месяцы и годы
図書	としょ	tosho	книги
年寄	としより	toshiyori	люди в возрасте
閉じる	とじる	tojiru	закрывать (например книгу; глаза) 
途端	とたん	totan	сейчас; на данный момент 
土地	とち	tochi	земельный участок 
突然	とつぜん	totsuzen	неожиданно; все сразу
	トップ	toppu	топ
届く	とどく	todoku	достичь
	とにかく	tonikaku	во всяком случае; так или иначе; так или иначе; вообще говоря 
飛ばす	とばす	tobasu	пропустить; опустить
飛び出す	とびだす	tobidasu	выпрыгнуть; выбежать; вылететь
留める	とめる	tomeru	останавливать; отключать; задерживать
友	とも	tomo	друг; приятель
共に	ともに	tomoni	обмена с; участвовать в
土曜	どよう	doyou	суббота
虎	とら	tora	тигр
	ドライブ	doraibu	поездка на автомобиле; вождение
	トラック	torakku	грузовик; трек
	ドラマ	dorama	драма
	トランプ	toranpu	игральные карты
取り上げる	とりあげる	toriageru	дисквалифицировать; конфисковать; лишить
努力	どりょく	doryoku	большое усилие; напряжение; усилия
どれ	どれ	dore	межд. ну, ну-ка; который (из трех или более)
	ドレス	doresu	платье
取れる	とれる	toreru	быть взятым, полученным
泥	どろ	doro	грязь
	とん	ton	тонна
	とんでもない	tondemonai	нелепый; ужасный; возмутительный; неожиданный; невероятный;
	どんな	donna	что; какие
	どんなに	donnani	как; сколько
	トンネル	tonneru	туннель
名	な	na	имя; название
内容	ないよう	naiyou	содержание; содержимое
	なお	nao	еще; все еще; подобно
仲	なか	naka	отношение; отношения
流す	ながす	nagasu	лить; проливать (кровь, слезы) 
	なかなか	nakanaka	очень; значительно;
半ば	なかば	nakaba	половина; полу-
仲間	なかま	nakama	сотрудник; коллега; товарищ
眺め	ながめ	nagame	сцена; вид; перспектива, прогноз
眺める	ながめる	nagameru	наблюдать; смотреть на
流れ	ながれ	nagare	поток 
流れる	ながれる	nagareru	течь; плыть
無し	なし	nashi	без
	なぜなら	nazenara	потому что
謎	なぞ	nazo	загадка; головоломка
納得	なっとく	nattoku	согласие; понимание
等	など	nado	и т.д. 
何か	なにか	nanika	что-то
	なにも	nanimo	ничего
鍋	なべ	nabe	кастрюля; горшок
生	なま	nama	сырой; необработанный
怠ける	なまける	namakeru	сидеть сложа руки; пренебрегать
波	なみ	nami	волна
涙	なみだ	namida	слеза
悩む	なやむ	nayamu	страдать; мучиться
為る/成る	なる	naru	стать
縄	なわ	nawa	веревка 
何で	なんで	nande	почему? зачем?
何でも	なんでも	nandemo	всеми средствами 
何とか	なんとか	nantoka	как-то; так или иначе 
似合う	にあう	niau	соответствовать; быть к лицу
匂い	におい	nioi	запах 
苦手	にがて	nigate	слабое место
握る	にぎる	nigiru	держать в руке
日	にち	nichi	солнце; день
日常	にちじょう	nichijou	повседневность; регулярно; обычно
日曜	にちよう	nichiyou	воскресенье
日光	にっこう	nikkou	солнечный свет
日中	にっちゅう	nicchuu	день 
	にっこり	nikkori	улыбаться
入院	にゅういん	nyuuin	госпитализация
入学	にゅうがく	nyuugaku	поступление в школу или университет
入場	にゅうじょう	nyuujou	вход, вход; ввода
人気	にんき	ninki	популярность; успех
人間	にんげん	ningen	человеческое существо, человек
抜く	ぬく	nuku	извлекать; вытягивать; отключать
抜ける	ぬける	nukeru	выпадать; выниматься; не хватать
布	ぬの	nuno	ткань
濡れる	ぬれる	nureru	промокать
	ね	ne	значение; цена; стоимость; стоит; заслуга
根	ね	ne	корень
値	ね	ne	значение; цена; стоимость
願い	ねがい	negai	желание; запрос
願う	ねがう	negau	желать; просить
鼠	ねずみ	nezumi	мышь; крыса; темно-серый 
値段	ねだん	nedan	цена, стоимость
熱心	ねっしん	nesshin	рвение; энтузиазм
熱帯	ねったい	nettai	тропики
熱中	ねっちゅう	necchuu	энтузиазм; рвение; мания
年間	ねんかん	nenkan	год
年月	ねんげつ	nengetsu	месяцы и годы
年中	ねんじゅう	nenjuu	целый год; всегда; каждый день
年代	ねんだい	nendai	возраст; эра; период, дата
年齢	ねんれい	nenrei	возраст; лет
野	の	no	поле
能	のう	nou	способности
農家	のうか	nouka	фермер 
農業	のうぎょう	nougyou	сельское хозяйство
農民	のうみん	noumin	фермеры; крестьяне
能力	のうりょく	nouryoku	способность; возможность
	ノー	no	нет
軒	のき	noki	карниз
残す	のこす	nokosu	оставлять; завещать; сохранять 
残り	のこり	nokori	остаток 
乗せる	のせる	noseru	сажать (пассажиров); класть; ставить
除く	のぞく	nozoku	удалять; исключять 
望み	のぞみ	nozomi	 желание; надежда
望む	のぞむ	nozomu	желать 
後	のち	nochi	потом; с тех пор; в будущем
	ノック	nokku	стук, удар (англ. knock)
喉	のど	nodo	горло
伸ばす	のばす	nobasu	удлинять; растягивать; дотягиваться
伸びる	のびる	nobiru	растягивать; расширять; добиться прогресса; отращивать
述べる	のべる	noberu	выражать
昇る	のぼる	noboru	подниматься; восходить
	のんびり	nonbiri	беззаботно; на досуге
場	ば	ba	место; поле (физика)
	はあ	haa	междометие " аа "
	パーセント	paasento	процент
	はい	hai	носить 
灰	はい	hai	пепел
梅雨	ばいう	baiu	сезона дождей
	バイオリン	baiorin	скрипка
	ハイキング	haikingu	пеший туризм
配達	はいたつ	haitatsu	доставка, распределение
	パイプ	paipu	трубы; каналы
俳優	はいゆう	haiyuu	актер; актриса; исполнитель
	パイロット	pairotto	пилот
墓	はか	haka	могила 
馬鹿	ばか	baka	идиот; глупость
博士	はかせ	hakase	профессор
計る	はかる	hakaru	измерять; взвешивать 
履く	はく	haku	носить; надевать (юбку, брюки)
吐く	はく	haku	дышать; рвать; извергать
拍手	はくしゅ	hakushu	аплодисменты
莫大	ばくだい	bakudai	огромный 
爆発	ばくはつ	bakuhatsu	взрыв; извержение
博物館	はくぶつかん	hakubutsukan	музей
激しい	はげしい	hageshii	жестоким; яростный; интенсивный
	はさみ	hasami	ножницы
破産	はさん	hasan	банкротство
端	はし	hashi	конец (например улицы); край; наконечник 
始まり	はじまり	hajimari	происхождения; начало
	パス	pasu	путь 
外す	はずす	hazusu	отстегнуть; удалить
	パスポート	pasupooto	паспорт
旗	はた	hata	флаг
肌	はだ	hada	кожа
裸	はだか	hadaka	голый; обнаженный
畑	はたけ	hatake	поле
二十	はたち	hatachi	20 лет; 20-й год
働き	はたらき	hataraki	работа; труда
	バッグ	baggu	сумка; ошибка
発見	はっけん	hakken	открытие, обнаружение; вывод
発行	はっこう	hakkou	выпуск; издание; публикация
発車	はっしゃ	hassha	отъезд автомобиля
罰する	ばっする	bassuru	наказывать
発達	はったつ	hattatsu	развитие; рост
	ばったり	battari	столкновение (стук); с треском; пухлый
発展	はってん	hatten	развитие; рост
発表	はっぴょう	happyou	объявление; публикация
発明	はつめい	hatsumei	изобретение
話し合う	はなしあう	hanashiau	обсуждать 
離す	はなす	hanasu	расстаться; разрыв; отдельный
放す	はなす	hanasu	отделять; установливать отпускать
離れる	はなれる	hanareru	отделяться; быть оставленным
羽	はね	hane	счетное слово для птиц и кроликов
幅	はば	haba	ширина; ширина
母親	ははおや	hahaoya	мать
省く	はぶく	habuku	опустить; устранить; свернуть; экономить
場面	ばめん	bamen	сцена, постановка (например романа)
腹	はら	hara	живот; брюхо 
原	はら	hara	поле; равнина;
針	はり	hari	игла, стрелка часов
張る	はる	haru	растягивать; расправлять
番	ばん	ban	число
	バン	ban	булочка; ван (караван); VAN 
範囲	はんい	hani	Степень; сфера; сфера; диапазон
反抗	はんこう	hankou	оппозиция; сопротивление
犯罪	はんざい	hanzai	преступление
	ハンサム	hansamu	красивый (о мужчине)
判断	はんだん	handan	суждение; решение
犯人	はんにん	hannin	преступник; уголовное
販売	はんばい	hanbai	продажа; продажи, маркетинг
灯	ひ	hi	свет
	ビール	biiru	пиво
被害	ひがい	higai	повреждение
比較	ひかく	hikaku	сравнение
轢く	ひく	hiku	сбить (транспортным средством)
	ピクニック	pikunikku	пикник
悲劇	ひげき	higeki	трагедия
飛行	ひこう	hikou	авиация
膝	ひざ	hiza	колено 
非常	ひじょう	hijou	чрезвычайно
美人	びじん	bijin	красавица
額	ひたい	hitai	лоб
	びっくり	bikkuri	удивляться; поражать; пугаться 
日付	ひづけ	hizuke	датировка; дата
必死	ひっし	hisshi	неизбежная смерть; отчаяние 
	ぴったり	pittari	точно; аккуратно; резкое
引っ張る	ひっぱる	hipparu	тянуть; тащить
否定	ひてい	hitei	отрицание; отказ
	ビデオ	bideo	видео
一言	ひとこと	hitokoto	одно слово
人込み	ひとごみ	hitogomi	толпа людей
等しい	ひとしい	hitoshii	равный
独り	ひとり	hitori	одинокий; не состоящий в браке
一人一人	ひとりひとり	hitorihitori	один за другим; по одному
批判	ひはん	hihan	критика; суждение; комментарий
批評	ひひょう	hihyou	критика; отзыв; комментарий
秘密	ひみつ	himitsu	тайна; секретность
微妙	びみょう	bimyou	деликатный; тонкое
紐	ひも	himo	шнур; шнурок
費用	ひよう	hiyou	стоимость; расходы
表	ひょう	hyou	таблица; схема; список
秒	びょう	byou	секунда
評価	ひょうか	hyouka	оценка
表現	ひょうげん	hyougen	выражение 
表情	ひょうじょう	hyoujou	выражение лица
平等	びょうどう	byoudou	равенство; беспристрастность 
評判	ひょうばん	hyouban	слава; репутация; популярность 
表面	ひょうめん	hyoumen	поверхность; снаружи
広がる	ひろがる	hirogaru	распространяться; расширять; растягивать 
瓶	びん	bin	бутылка
便	びん	bin	способ; средства
	ピン	pin	штифт
不	ふ(ぶ)	fu(bu)	отрицательная приставка
無	ぶ	bu	ничего; ничто; ноль 
分	ぶ	bu	разделительная; часть
不安	ふあん	fuan	беспокойство; беспокойство; неуверенность; саспенс
風景	ふうけい	fuukei	декорация
夫婦	ふうふ	fuufu	супружеская пара; муж и жена
笛	ふえ	fue	флейта; труба
不可	ふか	fuka	неправильно; нецелесообразно
武器	ぶき	buki	оружие
服装	ふくそう	fukusou	одежда
含む	ふくむ	fukumu	держать во рту; иметь в виду,
袋	ふくろ	fukuro	сумка; мешок
不幸	ふこう	fukou	несчастье; печаль; бедствие
節	ふし	fushi	сустав; нарост; узел 
無事	ぶじ	buji	безопасность; мир 
不思議	ふしぎ	fushigi	тайна; странность
不自由	ふじゆう	fujiyuu	дискомфорт; неудобство; несвобода
夫人	ふじん	fujin	жена;мадам
婦人	ふじん	fujin	женщина (замужняя)
不正	ふせい	fusei	несправедливость 
防ぐ	ふせぐ	fusegu	защищать; предотвращать
不足	ふそく	fusoku	недостаток; нехватка; дефицит; отсутствие 
舞台	ぶたい	butai	сцена театра
双子	ふたご	futago	близнецы
再び	ふたたび	futatabi	снова; еще раз
普段	ふだん	fudan	обычно; привычно
縁	ふち	fuchi	рамка; оправа; обод
打つ	ぶつ	butsu	ударять 
物価	ぶっか	bukka	цены на товары
物質	ぶっしつ	busshitsu	материал; вещество
物理	ぶつり	butsuri	физика
筆	ふで	fude	кисть
	ふと	futo	вдруг; случайно;неожиданно; непреднамеренно
船	ふね	fune	корабль; судно; пароход
部分	ぶぶん	bubun	часть 
不平	ふへい	fuhei	жалоба; недовольство 
不満	ふまん	fuman	недовольство; неудовольствие; жалобы 
	プラス	purasu	плюс
	プラン	puran	план
不利	ふり	furi	недостаток; неудобство
振る	ふる	furu	махать; пожать; качаться 
震える	ふるえる	furueru	дрожать; трястись
	ブレーキ	bureeki	тормоз
触れる	ふれる	fureru	коснуться; трогать; чувствовать
風呂	ふろ	furo	ванна
	プロ	puro	профессиональный
分	ぶん	bun	деление; часть; сегмент
文	ぶん	bun	фраза; письменность
雰囲気	ふんいき	funiki	атмосфера; настроение; окружение
分析	ぶんせき	bunseki	анализ
文明	ぶんめい	bunmei	цивилизация; культура
分野	ぶんや	bunya	поле; сфера; деление 
塀	へい	hei	стены; забор
平均	へいきん	heikin	равновесие; баланс 
平和	へいわ	heiwa	мир, гармония
別に	べつに	betsuni	(не) особенно, ничего
減らす	へらす	herasu	стихать; снижаться; уменьшаться 
減る	へる	heru	уменьшать (размер или количество); уменьшаться; стихать
	ベルト	beruto	пояс (в западной одежде)
変化	へんか	henka	изменение; перемена
	ペンキ	penki	краска
勉強	べんきょう	benkyou	исследование; изучение
変更	へんこう	henkou	изменение; модификация
	ベンチ	benchi	скамейка
方	ほう	hou	сторона
法	ほう	hou	закон; правило
棒	ぼう	bou	стержень; палка
冒険	ぼうけん	bouken	риск; приключение
方向	ほうこう	houkou	направление; курс; способ
報告	ほうこく	houkoku	отчет; информация
宝石	ほうせき	houseki	драгоценность; жемчужина
放送	ほうそう	housou	телевещание; трансляция
豊富	ほうふ	houfu	обилие; богатство 
方法	ほうほう	houhou	метод; образ; способ; средство
方々	ほうぼう	houbou	тут и там; везде
訪問	ほうもん	houmon	визит
吠える	ほえる	hoeru	лаять; выть; реветь; плакать
	ボーイ	booi	мальчик
	ボート	booto	весельная лодка
	ホーム	hoomu	платформа; дом
	ボール	booru	мяч; чаша
他	ほか	hoka	другие (особенно места и вещи)
外	ほか	hoka	другое (место)
誇り	ほこり	hokori	гордость
埃	ほこり	hokori	пыль
保証	ほしょう	hoshou	гарантия; безопасность; обеспечение; залог 
保存	ほぞん	hozon	сохранение; хранение; поддержание
程	ほど	hodo	степень; протяженность; границы; предел
歩道	ほどう	hodou	тропинка; тротуар
仏	ほとけ	hotoke	Будда; усопший
骨	ほね	hone	кость
炎	ほのお	honoo	пламя
頬	ほほ(ほお)	hoho(hoo)	щека 
	ほぼ	hobo	почти; примерно; примерно
微笑む	ほほえむ	hohoemu	улыбаться
褒める	ほめる	homeru	хвалить; восхищаться; хорошо говорить
濠	ほり	hori	ров
本当	ほんと(ほんとう)	honto(hontou)	Правда, реальность
本人	ほんにん	honnin	сам (лично]; лицо, о котором идёт речь
本物	ほんもの	honmono	подлинный товар
	ぼんやり	bonyari	рассеянно; тускло; смутно
間	ま	ma	пространство, комната; время; пауза
	まあ	maa	можно сказать (используется женщинами)
	マーケット	maaketto	рынок
	マイク	maiku	микрофон
迷子	まいご	maigo	потерявшийся ребенок
任せる	まかせる	makaseru	поручить; оставить
幕	まく	maku	занавес; акт (в игре)
負け	まけ	make	поражение 
孫	まご	mago	внук
	まさか	masaka	ни в коем случае
	まさに	masani	правильно; безусловно
真面目	まじめ	majime	прилежно; серьезно; честно
増す	ます	masu	увеличивать; расти
先ず	まず	mazu	во-первых
貧しい	まずしい	mazushii	бедный; нуждающийся
	マスター	masutaa	собственник; менеджер; мастер
	ますます	masumasu	более 
又	また	mata	снова; и
未だ	まだ	mada	но все же;кроме того
街	まち	machi	город; улица; дорога
間違い	まちがい	machigai	ошибка
松	まつ	matsu	сосна; высокий (в системах трехуровневого рейтинга)
真っ赤	まっか	makka	ярко красный 
真っ直ぐ	まっすぐ	massugu	прямо; вертикально
全く	まったく	mattaku	действительно; по-настоящему;полностью
祭	まつり	matsuri	Фестиваль; праздник
学ぶ	まなぶ	manabu	учиться; брать уроки
真似	まね	mane	мимика; имитация; поведение; притворство
招く	まねく	maneku	приглашать; зазывать
	ママ	mama	мама
豆	まめ	mame	фасоль; горох
守る	まもる	mamoru	защищать; охранять
丸	まる	maru	круг; совершенство;; счетный суффикс для названий судов
円	まる	maru	круг; деньги
丸い	まるい	marui	круглый; сферической
	まるで	marude	довольно; полностью 
回す	まわす	mawasu	превращать; вращаться
回り	まわり	mawari	окружность; окружение, тираж
万一	まんいち	manichi	по какой-то возможности;; 100 тысяч
満足	まんぞく	manzoku	удовлетворение
身	み	mi	тело; основная часть 
実	み	mi	фрукт; плод; семя; хороший результат
見送り	みおくり	miokuri	провожание; прощание 
味方	みかた	mikata	друг, союзник; сторонник
見事	みごと	migoto	великолепный; красивый 
	ミス	misu	мисс; ошибка 
満ちる	みちる	michiru	быть полным; приливать; созревать; истекать
密	みつ	mitsu	секрет; тайна
認める	みとめる	mitomeru	признать, оценить; утвердить; признать; замечать
皆	みんな	minna	каждый; все
見舞い	みまい	mimai	посещение (больного); выражение сочувствия 
土産	みやげ	miyage	сувенир
都	みやこ	miyako	капитал
妙	みょう	myou	странно; необычное
明後日	みょうごにち	myougonichi	послезавтра
未来	みらい	mirai	будущее (жизнь, время)
魅力	みりょく	miryoku	очарование; увлечение 
	ミルク	miruku	молоко
無	む	mu	ничего; ничто 
向かい	むかい	mukai	перед; напротив; на другой стороне
迎え	むかえ	mukae	встреча 
向く	むく	muku	направляться
向ける	むける	mukeru	повернуть в сторону 
無視	むし	mushi	пренебрежение; игнорирование
虫歯	むしば	mushiba	кариес 
寧ろ	むしろ	mushiro	лучше; вместо
結ぶ	むすぶ	musubu	связывать 
無駄	むだ	muda	тщетность; бесполезность
夢中	むちゅう	muchuu	не помня себя; как во сне; потерянно; рассеянно
胸	むね	mune	грудь
無料	むりょう	muryou	бесплатно 
芽	め	me	росток
明確	めいかく	meikaku	прояснить; уточнить; определить
命じる	めいじる	meijiru	приказывать; распоряжаться; назначать на должность
名人	めいじん	meijin	мастер; эксперт
命令	めいれい	meirei	команда; указ; директива; инструкция
迷惑	めいわく	meiwaku	беспокойство; раздражение
飯	めし	meshi	пища; рис (сваренный)
滅多に	めったに	mettani	редко (с отрицанием); редко
	メモ	memo	заметка
面	めん	men	лицо; кружка; поверхность; черты лица; маска; сторона или аспект 
綿	めん	men	хлопок; обивка
免許	めんきょ	menkyo	лицензия; разрешение; удостоверение
面倒	めんどう	mendou	трудность; беспокойство; хлопоты
	メンバー	menbaa	член
申し込む	もうしこむ	moushikomu	подать заявку 
申し訳	もうしわけ	moushiwake	извинение; оправдание
毛布	もうふ	moufu	одеяло
燃える	もえる	moeru	сжечь
目的	もくてき	mokuteki	цель; намерение
目標	もくひょう	mokuhyou	знак; цель 
木曜	もくよう	mokuyou	четверг
文字	もじ(もんじ)	moji(monji)	знак; буква; иероглиф
	もしも	moshimo	если
持ち上げる	もちあげる	mochiageru	быть поднятым; возникать; случаться; происходить
用いる	もちいる	mochiiru	использовать 
勿論	もちろん	mochiron	конечно; естественно
最も	もっとも	mottomo	наиболее; чрезвычайно
尤も	もっとも	mottomo	правильный; резонный; впрочем; правда
元	もと	moto	происхождение; оригинал; бывший
基	もと	moto	основа
素	もと	moto	то, из чего сделано; материал
戻す	もどす	modosu	возвращать
基づく	もとづく	motozuku	быть связаным с; происходить из
求める	もとめる	motomeru	искать; запрашивать; требовать; хотеть; желать; искать; охотиться 
者	もの	mono	человек
物音	ものおと	monooto	звуки
物語	ものがたり	monogatari	сказка; история; легенда
物事	ものごと	monogoto	вещи; все
模様	もよう	moyou	рисунок; фигура; дизайн
貰う	もらう	morau	получать
文句	もんく	monku	фраза; предложение
	やがて	yagate	в скором времени; и вскоре; затем
役	やく	yaku	выгода; роль; польза
約	やく	yaku	примерно; около 
訳	やく	yaku	перевод (с одного языка на другой)
役割	やくわり	yakuwari	часть; роль; обязанности
家賃	やちん	yachin	аренда
厄介	やっかい	yakkai	беда; бремя; беспокойство
宿	やど	yado	гостиница; жилье
雇う	やとう	yatou	использовать; нанимать
屋根	やね	yane	крыша
	やはり	yahari	также; как я думал; но все же; несмотря на; абсолютно; конечно
破る	やぶる	yaburu	рвать; нарушать; победить; чтобы разбить; уничтожить
辞める	やめる	yameru	уходить в отставку
	やや	yaya	немного; частично; несколько; короткое время;а
唯一	ゆいいつ	yuiitsu	только; единственный; уникальный
勇気	ゆうき	yuuki	мужество; храбрость; доблесть; смелость
有効	ゆうこう	yuukou	действие; эффективность
優秀	ゆうしゅう	yuushuu	превосходство; совершенство
優勝	ゆうしょう	yuushou	победа (спортивная)
友情	ゆうじょう	yuujou	дружба; общение
友人	ゆうじん	yuujin	друг
有能	ゆうのう	yuunou	состояние; способнность; умение
郵便	ゆうびん	yuubin	почта; почтовый сервис
夕べ	ゆうべ	yuube	вечер
	ユーモア	yuumoa	юмор
有利	ゆうり	yuuri	выгодно; лучше; прибыльно
床	ゆか	yuka	этаж
愉快	ゆかい	yukai	удовольствие
輸出	ゆしゅつ	yushutsu	экспорт
譲る	ゆずる	yuzuru	отдавать; передавать; уступать
豊か	ゆたか	yutaka	изобильный; богатый
	ゆっくり	yukkuri	медленно; непринужденно
輸入	ゆにゅう	yunyuu	импорт, импорт, внедрение
許す	ゆるす	yurusu	разрешать; утверждать
夜	よ	yo	вечер и ночь
夜明け	よあけ	yoake	рассвет 
様	よう	you	способ; образо; вид
酔う	よう	you	пьянеть
容易	ようい	youi	легко; просто; ясно
陽気	ようき	youki	сезон; погода; жизнерадостность
要求	ようきゅう	youkyuu	запрос; спрос 
用心	ようじん	youjin	осторожность, бдительность
様子	ようす	yousu	состояние; внешний вид
要するに	ようするに	yousuruni	одним словом; в конце концов; дело в том, ...
要素	ようそ	youso	элемент
要点	ようてん	youten	суть; главное
曜日	ようび	youbi	день недели
	ヨーロッパ	yooroppa	Европа
予期	よき	yoki	ожидание; предположение; прогноз
横切る	よこぎる	yokogiru	пересекать (например руки); проходитьти
予算	よさん	yosan	оценка; бюджет
止す	よす	yosu	прекращать; уйти в отставку; сдаваться
予測	よそく	yosoku	прогноз, оценка
	ヨット	yotto	яхта
夜中	よなか	yonaka	полночь; глубокая ночь
世の中	よのなか	yononaka	общество; мир; времена
余分	よぶん	yobun	излишек; избыток
予報	よほう	yohou	прогноз; предсказание
予防	よぼう	yobou	профилактика; предосторожность; защита от
読み	よみ	yomi	чтение
嫁	よめ	yome	невестка
余裕	よゆう	yoyuu	свобода (действий), возможности; достаточное количество (времени, денег)
	より	yori	чем; более
	よると	yoruto	в соответствии с
喜び	よろこび	yorokobi	радость; восторг; удовольствие; удовлетворение 
宜しい	よろしい	yoroshii	(вежливо) хорошо; все в порядке 
	よろしく	yoroshku	хорошо; должным образом; соответствующим образом; с наилучшими пожеланиями; очень приятно (при знакомстве)
四	よん	yon	четыре
来	らい	rai	грядущий
	ライター	raitaa	писатель
楽	らく	raku	комфорт; удовольствие
	ラケット	raketto	ракета
利益	りえき	rieki	прибыль; доходы; выгода
理解	りかい	rikai	понимание; понимание
陸	りく	riku	шесть (используется в документах)
利口	りこう	rikou	умный, проницательный; яркий; мудрый 
離婚	りこん	rikon	развод
理想	りそう	risou	идеал
率	りつ	ritsu	ставка; отношение; доля, процент
立派	りっぱ	rippa	великолепный; штраф; красивый; элегантный 
留学	りゅうがく	ryuugaku	обучение за рубежом
流行	りゅうこう	ryuukou	причуда; мода 
量	りょう	ryou	количество; объем 
両替	りょうがえ	ryougae	обмен валюты
料金	りょうきん	ryoukin	оплата 
例	れい	rei	экземпляр; пример; дело
礼	れい	rei	выражение благодарности
礼儀	れいぎ	reigi	манеры; любезно; этикет
冷静	れいせい	reisei	самообладание; спокойствие; безмятежность
列	れつ	retsu	очередь; линия; ряд
列車	れっしゃ	ressha	поезд 
	レポート	repooto	отчет 
練習	れんしゅう	renshuu	практика
連想	れんそう	rensou	ассоциация (идей); предложение
連続	れんぞく	renzoku	серийный; подряд; непрерывность 
労働	ろうどう	roudou	ручной труд; труд, работа
	ロケット	roketto	медальон; ракета
論じる	ろんじる	ronjiru	спорить; обсуждать 
論争	ろんそう	ronsou	полемика; спор
論文	ろんぶん	ronbun	тезис; эссе; трактат
輪	わ	wa	кольцо; обруч; круг
	ワイン	wain	вино
	わがまま	wagamama	эгоизм; своеволие; неповиновение; каприз
別れ	わかれ	wakare	расставание; разделение; прощание
脇	わき	waki	бок; боковая сторона; подмышка
分ける	わける	wakeru	разделить; отделить
	わざと	wazato	нарочно
僅か	わずか	wazuka	только; просто; немного; небольшое количество
綿	わた	wata	хлопок; обивка
話題	わだい	wadai	тема; предмет
笑い	わらい	warai	 смех; улыбка
割る	わる	waru	разделять; сокращать; ломать;
悪口	わるくち	warukuchi	оскорбление; клевета; злоречие
我々	われわれ	wareware	мы
	わん	wan	залив; бухта