	あ	a	ах
	ああ	aa	таким образом
	あいさつ・する	aisatsu suru	приветствовать
間	あいだ	aida	пространство
合う	あう	au	соответствовать
	あかちゃん	akachan	младенец
上る	あがる	agaru	расти
赤ん坊	あかんぼう	akanbou	ребенок
空く	あく	aku	 быть пустым; иметь зазор
	アクセサリー	akusesarii	аксессуар
	あげる	ageru	давать (вежл)
浅い	あさい	asai	мелкий; поверхностный
味	あじ	aji	вкус
	アジア	ajia	Азия
明日	あす	asu	завтра
遊び	あそび	asobi	играть
集る	あつまる	atsumaru	собирать
集める	あつめる	atsumeru	собрать; коллекционировать
	アナウンサー	anaunsaa	диктор
	アフリカ	afurika	Африка
	アメリカ	amerika	Америка
謝る	あやまる	ayamaru	извиняться
	アルコール	arukooru	алкоголь
	アルバイト	arubaito	работать на неполный рабочий день
安心	あんしん	anshin	спокойствие
安全	あんぜん	anzen	безопасность
	あんな	anna	такой; такие
案内	あんない・する	annai suru	давать руководство; информировать
以下	いか	ika	менее
以外	いがい	igai	за исключением
医学	いがく	igaku	медицина
生きる	いきる	ikiru	жить
意見	いけん	iken	мнение
石	いし	ishi	камень
	いじめる	ijimeru	дразнить
以上	いじょう	ijou	более
急ぐ	いそぐ	isogu	спешить
致す	いたす	itasu	(скромно) делать
	いただく	itadaku	(скромно) получать
一度	いちど	ichido	один раз
一生懸命	いっしょうけんめい	isshoukenmei	на пределе усилий
	いっぱい	ippai	сполна
糸	いと	ito	нить
以内	いない	inai	в
田舎	いなか	inaka	сельская местность
祈る	いのる	inoru	молиться; желать (в поздравлении)
	いらっしゃる	irassharu	(уважительно) быть; приходить
	いっていらっしゃい (いってらっしゃい)	itteirasshai	(часто в ответ на いっ て き ます) хорошего дня
	いってまいります	ittemairimasu	до свидания, я ухожу; увидимся позже
植える	うえる	ueru	посадить ; вырастить
	うかがう	ukagau	посещать
受付	うけつけ	uketsuke	квитанция
受ける	うける	ukeru	проходить урок или тест
動く	うごく	ugoku	двигаться
	うそ	uso	ложь
	うち	uchi	пока
打つ	うつ	utsu	ударять; бить
美しい	うつくしい	utsukushii	красивый
写す	うつす	utsusu	копировать; фотографировать
移る	うつる	utsuru	переезжать; переселяться
腕	うで	ude	рука
	うまい	umai	вкусный
裏	うら	ura	обратная сторона
売り場	うりば	uriba	прилавок; торговый зал
	うれしい	ureshii	радостный; счастливый
	うん	un	(разг.) да
運転	うんてん・する	unten suru	водить
運転手	うんてんしゅ	untenshu	водитель
運動	うんどう・する	undou suru	движение; физические упражнения
	エスカレーター	esukareetaa	эскалатор
枝	えだ	eda	филиал ; ветка
選ぶ	えらぶ	erabu	выбрать
遠慮	えんりょ・する	enryo suru	предусмотрительность; скромность
	おいでになる	oideninaru	(уважительно) быть
お祝い	おいわい	oiwai	поздравление
	オートバイ	ootobai	мотоцикл
	おかげ	okage	благодаря
	おかしい	okashii	странно; смешно
億	おく	oku	сто миллионов
屋上	おくじょう	okujou	на крыше
贈り物	おくりもの	okurimono	подарок
送る	おくる	okuru	отправлять
遅れる	おくれる	okureru	опаздывать
起す	おこす	okosu	будить
行う	おこなう	okonau	делать; исполнять
怒る	おこる	okoru	сердиться ; злиться
押し入れ	おしいれ	oshiire	стенной шкаф
お嬢さん	おじょうさん	ojousan	девушка;барышня
お宅	おたく	otaku	(вежливо) ваш дом
落る	おちる	ochiru	падать
	おっしゃる	ossharu	(уважительно) говорить
夫	おっと	otto	муж
	おつり	otsuri	сдача
音	おと	oto	звук ; нота
落す	おとす	otosu	падать
踊り	おどり	odori	танец
踊る	おどる	odoru	танцевать
驚く	おどろく	odoroku	удивляться
お祭り	おまつり	omatsuri	фестиваль
お見舞い	おみまい	omimai	навещать больных
お土産	おみやげ	omiyage	сувенир
思い出す	おもいだす	omoidasu	помнить
思う	おもう	omou	думать ; чувствовать
	おもちゃ	omocha	игрушка
表	おもて	omote	передняя сторона
親	おや	oya	родители
下りる	おりる	oriru	выйти(из транспорта); спуститься
折る	おる	oru	ломать; складывать
お礼	おれい	orei	благодарность; вежливость
折れる	おれる	oreru	быть сломленным; быть сложенным
終わり	おわり	owari	конец
	カーテン	kaaten	занавеска
海岸	かいがん	kaigan	побережье
会議	かいぎ	kaigi	встреча; собрание
会議室	かいぎしつ	kaigishitsu	конференц-зал
会場	かいじょう	kaijou	актовый зал; место встречи
会話	かいわ	kaiwa	разговор
帰り	かえり	kaeri	возвращение
変える	かえる	kaeru	меняться
科学	かがく	kagaku	наука
鏡	かがみ	kagami	зеркало
掛ける	かける	kakeru	висеть; прислоняться;
飾る	かざる	kazaru	украшать
火事	かじ	kaji	пожар
	ガス	gasu	газ
	ガソリン	gasorin	бензин
	ガソリンスタンド	gasorinsutando	АЗС
堅/硬/固い	かたい	katai	жесткий; твердый
形	かたち	katachi	форма
片付ける	かたづける	katazukeru	приводить в порядок
課長	かちょう	kachou	заведующий отделом
勝つ	かつ	katsu	побеждать
	かっこう	kakkou	форма; очертания
家内	かない	kanai	домохозяйка; жена
悲しい	かなしい	kanashii	печальный
必ず	かならず	kanarazu	конечно ; обязательно
お・金持ち	かねもち/おかねもち	kanemochi/okanemochi	богач
彼女	かのじょ	kanojo	она
壁	かべ	kabe	стена
	かまう	kamau	беспокоиться; обращать внимание
髪	かみ	kami	волосы
噛む	かむ	kamu	кусать; грызть
通う	かよう	kayou	ходить [туда и обратно]; циркулировать
	ガラス	garasu	стекло
彼	かれ	kare	он 
彼ら	かれら	karera	они
乾く	かわく	kawaku	высушивать
代わり	かわり	kawari	замена
変わる	かわる	kawaru	изменяться; переменяться
考える	かんがえる	kangaeru	рассмотреть
関係	かんけい	kankei	связь; отношение
看護婦	かんごふ	kangofu	медсестра; сиделка
簡単	かんたん	kantan	простой
気	き	ki	дух ; настроение
機会	きかい	kikai	возможность; шанс
危険	きけん	kiken	опасность
聞こえる	きこえる	kikoeru	быть слышным; звучать
汽車	きしゃ	kisha	паровоз
技術	ぎじゅつ	gijutsu	искусство; технология ; мастерство
季節	きせつ	kisetsu	сезон
規則	きそく	kisoku	правила
	きっと	kitto	точно; обязательно
絹	きぬ	kinu	шелк
厳しい	きびしい	kibishii	строгий
気分	きぶん	kibun	настроение
決る	きまる	kimaru	быть определенным
君	きみ	kimi	(неофициально) Вы (используется мужчинами по отношению к женщинам)
決める	きめる	kimeru	решать
気持ち	きもち	kimochi	чувство ; настроение
着物	きもの	kimono	кимоно
客	きゃく	kyaku	гость ; клиент
急	きゅう	kyuu	срочно
急行	きゅうこう	kyuukou	экспресс
教育	きょういく	kyouiku	образование
教会	きょうかい	kyoukai	церковь
競争	きょうそう	kyousou	конкуренция
興味	きょうみ	kyoumi	интерес
近所	きんじょ	kinjo	окрестности
具合	ぐあい	guai	состояние ; здоровье
空気	くうき	kuuki	воздух; атмосфера
空港	くうこう	kuukou	аэропорт
草	くさ	kusa	трава
	くださる	kudasaru	(уважительно) давать (о действии 2-го или 3-го лица)
首	くび	kubi	шея
雲	くも	kumo	облако
比べる	くらべる	kuraberu	сравнить
	くれる	kureru	давать, дарить (о 2-м и 3-м лице)
暮れる	くれる	kureru	темнеть; чтобы прийти к концу
君	くん	kun	именной суффикс (используется по отношению к молодым мужчинам)
毛	け	ke	шерсть; мех
計画	けいかく・する	keikaku suru	планировать
経験	けいけん・する	keiken suru	испытывать
経済	けいざい	keizai	финансы; экономика
警察	けいさつ	keisatsu	полиция
	ケーキ	keeki	торт
	けが・する	kega suru	ранить
景色	けしき	keshiki	сцена ; пейзаж
消しゴム	けしゴム	keshigomu	ластик
下宿	げしゅく	geshuku	жилье
決して	けっして	kesshite	никогда (с отрицанием)
	けれど/けれども	keredo/keredomo	однако
原因	げんいん	genin	причина ; источник
	けんか・する	kenka suru	ссориться
研究	けんきゅう	kenkyuu	исследование
研究室	けんきゅうしつ	kenkyuushitsu	кабинет; лаборатория
見物	けんぶつ	kenbutsu	экскурсия
子	こ	ko	ребенок
	こう	kou	так
郊外	こうがい	kougai	окраина
講義	こうぎ	kougi	лекция
工業	こうぎょう	kougyou	промышленность; индустрия
高校	こうこう	koukou	средняя школа
高校生	こうこうせい	koukousei	учащийся средней школы
工場	こうじょう	koujou	завод
校長	こうちょう	kouchou	директор
交通	こうつう	koutsuu	трафик ; транспорт
講堂	こうどう	koudou	аудитория
高等学校	こうとうがっこう	koutougakkou	средняя школа
公務員	こうむいん	koumuin	политик
国際	こくさい	kokusai	международный
心	こころ	kokoro	ядро; сердце
御主人	ごしゅじん	goshujin	(с уважением) ваш муж
故障	こしょう・する	koshou suru	сломать
ご存じ	ごぞんじ	gozonji	вы знаете; вам известно
答	こたえ	kotae	ответ
	ごちそう	gochisou	угощение
	こと	koto	вещь ; факт; случай
小鳥	ことり	kotori	маленькая птичка
	このあいだ	konoaida	На днях ; в последнее время
	このごろ	konogoro	в настоящее время
細かい	こまかい	komakai	мелкий; тщательный
	ごみ	gomi	мусор
込む	こむ	komu	быть переполненным
米	こめ	kome	рис (в зерне)
	ごらんになる	goranninaru	(уважительно) видеть
	これから	korekara	теперь; впредь
怖い	こわい	kowai	страшный
壊す	こわす	kowasu	ломать
壊れる	こわれる	kowareru	быть поломанным
	コンサート	konsaato	концерт
今度	こんど	kondo	теперь ; в этот раз
	コンピュータ/コンピューター	konpyuuta/konpyuutaa	компьютер
今夜	こんや	konya	сегодня вечером
最近	さいきん	saikin	последнее время
最後	さいご	saigo	наконец; последний
最初	さいしょ	saisho	самый первый
坂	さか	saka	склон; холм
探す	さがす	sagasu	искать
下る	さがる	sagaru	спускаться
盛ん	さかん	sakan	процветающий
下げる	さげる	sageru	вешать; спускать
差し上げる	さしあげる	sashiageru	(вежливо) давать, поднимать
	さっき	sakki	некоторое время назад
寂しい	さびしい	sabishii	одинокий
さ来月	さらいげつ	saraigetsu	через месяц
さ来週	さらいしゅう	saraishuu	через неделю
	サラダ	sarada	салат
騒ぐ	さわぐ	sawagu	шуметь
触る	さわる	sawaru	касаться
産業	さんぎょう	sangyou	промышленность
	サンダル	sandaru	сандал
	サンドイッチ	sandoicchi	бутерброд
残念	ざんねん	zannen	разочарование
市	し	shi	город
死	し	shi	смерть
字	じ	ji	знак; иероглиф
試合	しあい	shiai	матч; игра
仕方	しかた	shikata	метод
	しかる	shikaru	ругать; бранить
試験	しけん	shiken	экзамен
事故	じこ	jiko	авария
地震	じしん	jishin	землетрясение
時代	じだい	jidai	эпоха
下着	したぎ	shitagi	нижнее белье
支度	したく・する	shitaku suru	подготовка; сборы
	しっかり	shikkari	твердо ; неуклонно
失敗	しっぱい	shippai	неудача; ошибка
辞典	じてん	jiten	словарь
品物	しなもの	shinamono	товары
	しばらく	shibaraku	некоторое время
島	しま	shima	остров
市民	しみん	shimin	гражданин
事務所	じむしょ	jimusho	офис
社会	しゃかい	shakai	общество
社長	しゃちょう	shachou	президент компании
	じゃま	jama	помеха; неудобство
	ジャム	jamu	варенье
自由	じゆう	jiyuu	свобода
習慣	しゅうかん	shuukan	обычай; нравы
住所	じゅうしょ	juusho	адрес ; место жительства
柔道	じゅうどう	juudou	дзюдо
十分	じゅうぶん	juubun	достаточно
出席	しゅっせき・する	shusseki suru	учавствовать; присутствовать
出発	しゅっぱつ・する	shuppatsu suru	выезжать; отправляться
趣味	しゅみ	shumi	хобби
準備	じゅんび・する	junbi suru	подготавливать
紹介	しょうかい	shoukai	введение
小学校	しょうがっこう	shougakkou	начальная школа
小説	しょうせつ	shousetsu	роман
招待	しょうたい・する	shoutai suru	приглашать
承知	しょうち・する	shouchi suru	давать согласие
将来	しょうらい	shourai	будущее; перспективы
食事	しょくじ・する	shokuji suru	принятие пищи; еда
食料品	しょくりょうひん	shokuryouhin	бакалейные товары
女性	じょせい	josei	женщина
知らせる	しらせる	shiraseru	уведомлять
調べる	しらべる	shiraberu	исследовать
人口	じんこう	jinkou	население
神社	じんじゃ	jinja	синтоистский храм
親切	しんせつ	shinsetsu	доброта
心配	しんぱい・する	shinpai suru	беспокоиться
新聞社	しんぶんしゃ	shinbunsha	газетное издательство
水泳	すいえい	suiei	плавание
水道	すいどう	suidou	водоснабжение
	ずいぶん	zuibun	чрезвычайно
数学	すうがく	suugaku	математика; арифметика
	スーツ	suutsu	костюм
	スーツケース	suutsukeesu	чемодан
過ぎる	すぎる	sugiru	превышать
	すく	suku	пустеть; быть пустым
	スクリーン	sukuriin	экран
凄い	すごい	sugoi	потрясающий
進む	すすむ	susumu	продвигаться; добиваться прогресса
	すっかり	sukkari	полностью
	すっと	sutto	прямо; внезапно
	ステーキ	suteeki	стейк
捨てる	すてる	suteru	выбрасывать
	ステレオ	sutereo	стерео
砂	すな	suna	песок
	すばらしい	subarashii	замечательный
滑る	すべる	suberu	скользить ; скользить
隅	すみ	sumi	угол (внешний)
済む	すむ	sumu	заканчивать
	すり	suri	карманник
	すると	suruto	затем
生活	せいかつ・する	seikatsu suru	жить; существовать
生産	せいさん・する	seisan suru	производить
政治	せいじ	seiji	политика; правительство
西洋	せいよう	seiyou	западные страны
世界	せかい	sekai	мир
席	せき	seki	сиденье
説明	せつめい	setsumei	объяснение
背中	せなか	senaka	спина
	ぜひ	zehi	обязательно
世話	せわ・する	sewa suru	заботиться
線	せん	sen	линия
	ぜんぜん	zenzen	не полностью (используется c отрицанием)
戦争	せんそう	sensou	война
先輩	せんぱい	senpai	старший товарищ
	そう	sou	итак
相談	そうだん・する	soudan suru	обсуждать
育てる	そだてる	sodateru	растить; воспитывать
卒業	そつぎょう	sotsugyou	выпускаться (из учебного заведения)
祖父	そふ	sofu	дед
	ソフト	sofuto	мягкий
祖母	そぼ	sobo	бабушка
	それで	sorede	по этой причине
	それに	soreni	к тому же; вдобавок
	それほど	sorehodo	настолько; так
	そろそろ	sorosoro	постепенно; в ближайшее время
	そんな	sonna	такого рода
	そんなに	sonnani	так много; как ; что
退院	たいいん・する	taiin suru	выписываться из больницы
大学生	だいがくせい	daigakusei	студент университета
大事	だいじ	daiji	важно ; ценно; серьезное дело
大体	だいたい	daitai	обычно
	たいてい	taitei	обычно
	タイプ	taipu	тип ; стиль
大分	だいぶ	daibu	значительно
台風	たいふう	taifuu	тайфун
倒れる	たおれる	taoreru	падать; валиться
	だから	dakara	так ; поэтому
確か	たしか	tashika	определенный
足す	たす	tasu	складывать (о числах)
訪ねる	たずねる	tazuneru	посещать
尋ねる	たずねる	tazuneru	спрашивать; разыскивать
正しい	ただしい	tadashii	верный
畳	たたみ	tatami	татами
立てる	たてる	tateru	стоять
建てる	たてる	tateru	строить
例えば	たとえば	tatoeba	например
棚	たな	tana	полка
楽しみ	たのしみ	tanoshimi	радость
楽む	たのしむ	tanoshimu	веселиться
	たまに	tamani	иногда
為	ため	tame	для того; чтобы
	だめ	dame	нельзя
足りる	たりる	tariru	быть достаточчным
男性	だんせい	dansei	мужской пол
暖房	だんぼう	danbou	отопление
血	ち	chi	кровь
	チェック・する	chekku suru	проверять
力	ちから	chikara	сила; мощь
	ちっとも	chittomo	совсем (с отрицанием)
	ちゃん	chan	именной суффикс (о знакомых женского пола)
注意	ちゅうい	chuui	осторожность
中学校	ちゅうがっこう	chuugakkou	средняя школа 
注射	ちゅうしゃ	chuusha	инъекция
駐車場	ちゅうしゃじょう	chuushajou	стоянка для машин
地理	ちり	chiri	география
捕まえる	つかまえる	tsukamaeru	схвавтить; поймать
	つき	tsuki	луна
付く	つく	tsuku	приклеивать; пислонять
漬ける	つける	tsukeru	вымачивать; мариновать
都合	つごう	tsugou	обстоятельства ; положение
伝える	つたえる	tsutaeru	сообщать
続く	つづく	tsuzuku	продолжать
続ける	つづける	tsuzukeru	продолжаться; следовать
包む	つつむ	tsutsumu	оборачивать
妻	つま	tsuma	(скромно)моя жена
	つもり	tsumori	намерение
釣る	つる	tsuru	ловить рыбу
連れる	つれる	tsureru	вести
丁寧	ていねい	teinei	вежливый
	テキスト	tekisuto	текст; текст книги
適当	てきとう	tekitou	пригодность
	できるだけ	dekirudake	насколько возможно
手伝う	てつだう	tetsudau	помогать
	テニス	tenisu	теннис
手袋	てぶくろ	tebukuro	перчатка
寺	てら	tera	храм
点	てん	ten	точка
店員	てんいん	tenin	продавец
天気予報	てんきよほう	tenkiyohou	прогноз погоды
電灯	でんとう	dentou	электрический свет
電報	でんぽう	denpou	телеграмма
展覧会	てんらんかい	tenrankai	выставка
都	と	to	столица
道具	どうぐ	dougu	инструмент ; средства
	とうとう	toutou	наконец ; в конце концов
動物園	どうぶつえん	doubutsuen	зоопарк
遠く	とおく	tooku	далеко
通る	とおる	tooru	проходить
特に	とくに	tokuni	в частности ; особенно
特別	とくべつ	tokubetsu	специальный
	とこや	tokoya	парикмахер
途中	とちゅう	tochuu	в пути
特急	とっきゅう	tokkyuu	специальный экспресс (быстрее, чем поезд-экспресс)
届ける	とどける	todokeru	достигать
泊まる	とまる	tomaru	останавливаться на ночь; ночевать
止める	とめる	tomeru	останавливать
取り替える	とりかえる	torikaeru	обменивать
泥棒	どろぼう	dorobou	вор
	どんどん	dondon	все более и более
直す	なおす	naosu	исправлять ; чинить
直る	なおる	naoru	быть исправленным; выздоравливать
治る	なおる	naoru	лечить; чинить
中々	なかなか	nakanaka	очень; весьма
泣く	なく	naku	плакать
無くなる	なくなる	nakunaru	исчезать; теряться
亡くなる	なくなる	nakunaru	умирать
投げる	なげる	nageru	бросать;разбрасывать
	なさる	nasaru	(уважительно) делать
鳴る	なる	naru	звучать
	なるべく	narubeku	как можно больше
	なるほど	naruhodo	теперь я понимаю; понятно
慣れる	なれる	nareru	привыкать
	におい	nioi	запах
苦い	にがい	nigai	горький
二階建て	にかいだて	nikaidate	двухэтажный
逃げる	にげる	nigeru	бегать; убегать
日記	にっき	nikki	журнал
入院	にゅういん・する	nyuuin suru	госпитализировать
入学	にゅうがく・する	nyuugaku suru	поступать в школу или университет
似る	にる	niru	быть похожим
人形	にんぎょう	ningyou	кукла ; фигура
盗む	ぬすむ	nusumu	красть
塗る	ぬる	nuru	рисовать; покрывать лаком
	ぬれる	nureru	промокать
	ねだん	nedan	цена
熱	ねつ	netsu	жар; температуа
	ねっしん	nesshin	энтузиазм
寝坊	ねぼう	nebou	человек, который спит допоздна
眠い	ねむい	nemui	сонный
眠る	ねむる	nemuru	спать
残る	のこる	nokoru	оставаться
	のど	nodo	горло
乗り換える	のりかえる	norikaeru	менять транспорт, пересаживаться
乗り物	のりもの	norimono	автомобиль
葉	は	ha	лист (дерева)
場合	ばあい	baai	ситуация
	パート	paato	неполный рабочий день
倍	ばい	bai	двойной
拝見	はいけん・する	haiken suru	(скромно) смотреть
歯医者	はいしゃ	haisha	дантист
運ぶ	はこぶ	hakobu	переносить; тащить
始める	はじめる	hajimeru	начать
場所	ばしょ	basho	место
	はず	hazu	наверное
恥ずかしい	はずかしい	hazukashii	смущенный
	パソコン	pasokon	персональный компьютер
発音	はつおん	hatsuon	произношение
	はっきり	hakkiri	точно
花見	はなみ	hanami	любование сакурой
林	はやし	hayashi	лес
払う	はらう	harau	платить
番組	ばんぐみ	bangumi	теле или радио программа
反対	はんたい	hantai	оппозиция; сопротивление
	ハンドバッグ	handobaggu	сумка
日	ひ	hi	день; солнце
火	ひ	hi	огонь
	ピアノ	piano	пианино
冷える	ひえる	hieru	охлаждаться
光	ひかり	hikari	свет
光る	ひかる	hikaru	сиять ; блестеть
引き出し	ひきだし	hikidashi	выдвижной ящик
引き出す	ひきだす	hikidasu	отозывать
	ひげ	hige	борода
飛行場	ひこうじょう	hikoujou	аэропорт
久しぶり	ひさしぶり	hisashiburi	после долгого времени
美術館	びじゅつかん	bijutsukan	художественная галерея
非常に	ひじょうに	hijouni	чрезвычайно
	びっくり・する	bikkuri suru	удивляться
引っ越す	ひっこす	hikkosu	переезжать на другую квартиру
必要	ひつよう	hitsuyou	необходимо
	ひどい	hidoi	ужасный
開く	ひらく	hiraku	открывать 
	ビル	biru	здание
昼間	ひるま	hiruma	день ; в течение дня
昼休み	ひるやすみ	hiruyasumi	полуденный перерыв
拾う	ひろう	hirou	подобирать; собирать
	ファックス	fakkusu	факс
増える	ふえる	fueru	увеличивать
深い	ふかい	fukai	глубокий
複雑	ふくざつ	fukuzatsu	сложный; запутанный
復習	ふくしゅう	fukushuu	пересмотр
部長	ぶちょう	buchou	заведующий отделом
普通	ふつう	futsuu	обычный; простой
	ぶどう	budou	виноград
太る	ふとる	futoru	толстеть
布団	ふとん	futon	японское одело; футон
舟	ふね	fune	корабль
不便	ふべん	fuben	неудобство
踏む	ふむ	fumu	наступать на
降り出す	ふりだす	furidasu	начинаться (о дожде)
	プレゼント	purezento	подарок
文化	ぶんか	bunka	культура
文学	ぶんがく	bungaku	литература
文法	ぶんぽう	bunpou	грамматика
別	べつ	betsu	другой
	ベル	beru	колокольчик
変	へん	hen	странный
返事	へんじ	henji	ответ
貿易	ぼうえき	boueki	торговля
放送	ほうそう・する	housou suru	транслировать
法律	ほうりつ	houritsu	закон
僕	ぼく	boku	я (неформальный мужской ваиант)
星	ほし	hoshi	звезда
	ほど	hodo	степень
	ほとんど	hotondo	главным образом
	ほめる	homeru	хвалить
翻訳	ほんやく	honyaku	перевод
参る	まいる	mairu	(скромно) идти
負ける	まける	makeru	проигрывать
	まじめ	majime	серьезно
	まず	mazu	в первую очередь
	または	matawa	или же
間違える	まちがえる	machigaeru	ошибаться
間に合う	まにあう	maniau	успевать
周り	まわり	mawari	окрестности
回る	まわる	mawaru	ходить вокруг
漫画	まんが	manga	манга; комиксы
真中	まんなか	mannaka	самая середина
見える	みえる	mieru	быть на виду
湖	みずうみ	mizuumi	озеро
味噌	みそ	miso	мисо, паста из соевых бобов
見つかる	みつかる	mitsukaru	быть обнаруженным
見つける	みつける	mitsukeru	обнаружить
皆	みな	mina	все
港	みなと	minato	гавань
向かう	むかう	mukau	к лицу
迎える	むかえる	mukaeru	пойти навстречу
昔	むかし	mukashi	старину ; бывший
虫	むし	mushi	насекомое
息子	むすこ	musuko	(скромно) сын
娘	むすめ	musume	(скромно) дочь
無理	むり	muri	невозможно
召し上がる	めしあがる	meshiagaru	(вежливо) есть
珍しい	めずらしい	mezurashii	редкий
申し上げる	もうしあげる	moushiageru	(скромно) говорить
申す	もうす	mousu	(скромно) называться
	もうすぐ	mousugu	скоро
	もし	moshi	если
	もちろん	mochiron	конечно
	もっとも	mottomo	чрезвычайно
戻る	もどる	modoru	возващать
木綿	もめん	momen	хлопок
	もらう	morau	получать
森	もり	mori	лес
焼く	やく	yaku	печь ; жарить
約束	やくそく	yakusoku	обещание
役に立つ	やくにたつ	yakunitatsu	быть полезным
焼ける	やける	yakeru	быть поджаренным; подгореым
優しい	やさしい	yasashii	нежный; добый
痩せる	やせる	yaseru	худеть
	やっと	yatto	наконец
	やはり/やっぱり	yahari/yappari	как я думал ; абсолютно
止む	やむ	yamu	 останавливаться
止める	やめる	yameru	останавливать
柔らかい	やわらかい	yawarakai	мягкий
湯	ゆ	yu	горячая вода
輸出	ゆしゅつ・する	yushutsu suru	экспортировать
輸入	ゆにゅう・する	yunyuu suru	импортировать
指	ゆび	yubi	палец
指輪	ゆびわ	yubiwa	кольцо
夢	ゆめ	yume	мечтать
揺れる	ゆれる	yureru	трясти; колебать
用	よう	you	использовать
用意	ようい	youi	подготовка
用事	ようじ	youji	развлечения
汚れる	よごれる	yogoreru	пачкаться
予習	よしゅう	yoshuu	подготовка к уроку
予定	よてい	yotei	расположение
予約	よやく	yoyaku	бронирование
寄る	よる	yoru	посещать
喜ぶ	よろこぶ	yorokobu	быть в восторге; радоваться
	よろしい	yoroshii	(уважительно) хороший; хорошо
理由	りゆう	riyuu	причина
利用	りよう	riyou	использование
両方	りょうほう	ryouhou	обе стороны
旅館	りょかん	ryokan	японский отель
留守	るす	rusu	пребывание вне дома; отсутствие
冷房	れいぼう	reibou	охлаждение (кондиционирование) воздуха
歴史	れきし	rekishi	история
	レジ	reji	регистр
	レポート/リポート	repooto/ripooto	отчет
連絡	れんらく	renraku	контакт
	ワープロ	waapuro	текстовый процессор
沸かす	わかす	wakasu	кипятить
別れる	わかれる	wakareru	отделять
沸く	わく	waku	кипятить
訳	わけ	wake	смысл; причина
忘れ物	わすれもの	wasuremono	потерянная вещь
笑う	わらう	warau	смеяться; улыбаться
割合	わりあい	wariai	ставка; коэффициент ; процент
割れる	われる	wareru	ломать
泳ぎ方	およぎかた	oyogikata	стиль плавания